They said the man came from the north, through Roper's Gate. He came on foot, leading his laden horse by the bridle. The street lay empty. The day was hot, yet the man wore a black coat thrown over his shoulders, as though the heat meant nothing to him. He drew attention to himself. With a heavy, unhurried stride, the stranger shifted the two swords strapped across his back. Though hidden beneath the coat, their shape remained unmistakable. He was not old, though his hair was white as a dead man's. White as bone.

A boy, peering between the slats of a fence, tugged at his mother's sleeve.

"Mama... that man carries two swords on his back. Like a bow."

His mother pulled him closer without looking.

"People say witchers always carry two swords," she murmured. "One for men. One for monsters." She paused. "They say some can't tell the difference anymore."

The Witcher
An Interactive Fiction by António Alves
Release 1 / Serial number 260323 / Inform 7 v10.1.2 / D

Crossroads
You stand in front of the Old Narakort Inn, facing north. You spend a few seconds looking at the entrance, listening to the hubbub of voices. The Inn is full of people who may get the wrong impression of you. Farther down the street there is a smaller inn named The Fox, facing south. It is quite empty. You think about a contract you could make and a place to sleep when the night falls. Maybe a quiet place is a good option.

You see a wad of white goat leather nailed to the wood near the entrance, with some runes written on it. You already saw the same leather across the road, on notice boards.

>RESTORE
Restore failed.

>check it
You get closer and see that it is a proclamation, signed by Foltest, King of Temeria, Pontar and Mahakam... You might want to examine it further to read the details.

>check it
You read the proclamation carefully:

"BY ORDER OF KING FOLTEST OF TEMERIA

Let it be known to all citizens of Wyzim and its surroundings:

The palace district is hereby forbidden to all persons, by penalty of death. None shall enter, none shall linger after dark.

A creature of unknown nature dwells within the old palace vaults. It is dangerous. It kills. Fourteen years have passed since the curse was laid and seven since it first stirred.

His Majesty King Foltest, in his mercy, forbids any attempt upon the creature's life.

His Majesty hereby calls upon any man of skill and knowledge, witcher, sorcerer, or wise man, who believes themselves capable of lifting the curse upon the creature, to present themselves before the castellan Velerad at Wyzim.

Any man or woman capable of lifting the curse without harm to the creature shall be rewarded handsomely by the crown with three thousand oren.

Those who attempt to destroy the creature instead of breaking the spell will be tried for treason."

You think about pulling it off in case you need to ask about it.

>pull it
You pull the leather off the wood, roll it up and tuck it into your jerkin. This certainly will be useful later.

>go south
You push open the door of The Fox. The hinges creak. Inside, it is dim and quiet. Just the way you like it.

Fox Inn
The Fox is quiet. A few candles burn low on the tables. The innkeeper glances up at you without alarm. He has seen worse, or at least pretends he has. This will do. The innkeeper eyes the hilt of your sword and then your face. He opens his mouth, thinks better of it, closes it again. He looks like a man with something heavy on his chest.

The innkeeper is a broad-shouldered man with a trimmed grey beard and careful eyes. He keeps his hands on the bar, easy and visible. You can ask for a room to stay the night.  Or you could ask about the proclamation...

>ask him about it
The innkeeper studies you a moment, then sets down the rag he was using to wipe the bar.  "You're a witcher, aren't you?" He does not wait for an answer. "I can always tell. The eyes... You... That white hair. Also the medallion. A wolf... from Kaer Mor... Something like that. You know, one called Vesemir had hair almost like yours. Maybe I should not ask about it. A lot of witchers pass here and some talk and I listen." He pours a cup of something dark and slides it across the counter without being asked. "I'll not throw you out," he says. "A man's coin is a man's coin. But..." He hesitates. "Have you seen the proclamation?"

He glances toward the door before he speaks again.
The innkeeper lowers his voice. "The proclamation on the gate. I expect you read it." He glances around the empty room, habit more than caution. "Fourteen years ago a curse fell on the old palace. The creature that lives in the vaults... folks say it is a terrible monster. A cursed thing, half woman, half beast. Kills without reason. Velerad, the king's castellan, he is the one offering the contract. His office is in the castle keep, north through the market. This market is not far from my inn. You should get there easily by just going east from here."

He refills your cup."I'll give you a room, witcher. Cheapest in Wyzim. Consider it goodwill. We could use someone who isn't afraid of that thing." He slides a key across the worn wood of the bar. You scoop it up, feeling the cold iron against your palm, and secure it in your pocket.

>go east
Market Square
The market is winding down for the evening. Stall holders roll up their cloth and argue over the day's takings. At the far end, a barber is still open, with his red and white pole catching the last of the light. On the opposite side, a merchant with silver streaked hair sits at a tavern table with a cup that never seems to empty.

The Barber is a thin and a fidgety man with nimble fingers and has restless eyes. He has the barber's habit of talking to fill silence, or to play the role of an unsolicited therapist. You can try and ask him about the proclamation.

The merchant is a broad, well dressed man who seems entirely too comfortable for someone living in a city with a monster problem. He has the look of a man who has learned that gold can buy distance from most troubles. You can try and ask him about the proclamation.

On the wall at the northern end of the market, near the palace gate, someone has scratched a crude calendar into the stone. Fourteen years worth of marks, each month noted. And beside the seventh year, a different mark, a rough shape like a curled, sleeping figure, and beside it an arrow pointing east. Toward the palace.

>go north
Castle Keep
The castle is old and smells of damp stone and old candles. Guards eye you at the gate but let you pass. They know the look of someone who has come about the contract. Inside, the keep is dim, the tapestries faded. Velerad's office is at the end of the main corridor.

Velerad is a heavyset man in his fifties with a soldier's posture and a bureaucrat's tired eyes. He sits behind a broad desk covered in papers.

A rolled map of the palace district lies on the corner of Velerad's desk.

A stiff parchment with Velerad's seal and the terms of the commission.

>ask him about it
Velerad sets down his quill. "That medallion... A witcher. Good. Sit down." He does not wait to see if you will. "I am going to tell you everything, because the men I sent before you all died, and I am tired of burying good soldiers over a thing that might be fixed." He folds his hands.

"The creature is the king's daughter. Adda. Born under a curse laid by a wise woman at the birth. The circumstances I will not go into, they are... unpleasant, and irrelevant. For seven years she lay in the crypt below the palace, still. We thought the curse had come to nothing. Then she woke."

He stands and moves to a cabinet, pulling out a rolled map, which he sets flat on the desk. "The palace vaults below the old throne room. She lives there. The crypt has a sarcophagus, where she sleeps by day. At night she hunts. The king will not allow her to be killed, because she is his daughter. He believes the curse can be broken and I am... less certain. But those are my orders, and so I am offering three thousand oren to anyone who can lift it. A crazy old man once said that someone must spend the night with the thing until the cock crows for the third time. You should see what remains of him..." Velerad laughs. You know the old man was likely right. You've heard of this before. It is no wonder he died, however, as a striga is a formidable monster, even witchers struggle against one.

Velerad slides a document across the desk. It is a map. You should examine further.

"The crypt lies below the palace, through the old throne room, down one flight. The sarcophagus is in the eastern vault. You will need to go at night. The creature only emerges at night. Witcher, do you know how to break a striga's curse? Well good luck because I don't and don't care. To me this monster should be killed, and if it comes to that Witcher..." Velerad starts laughing. "If you must, kill it, but i can't help you if it comes to that.". 

You have many details on how the monster behaves, and maybe how to break the curse. "Just one more thing Witcher! Sign the contract before you leave and I will tell you something usefull! Or just leave if you don't like contracts..."

>sign in
You must name something more substantial.

>sign it
You must name something more substantial.

>sign it
You must name something more substantial.

>sign contract
You sign your mark at the bottom of the contract. Velerad passes the ink and nods. "Good. The palace gate will be unlocked for you tonight. Do not go in before dark. The guards have orders to let no one through during the day. The creature sleeps, and we want it to stay that way until you are ready. One more thing. There is a herbalist on the south side of the market. She may have something useful for you." He writes a name on a slip of paper and hands it to you. "Mention my name."

>go south
Market Square
The market is winding down for the evening. Stall holders roll up their cloth and argue over the day's takings. At the far end, a barber is still open, with his red and white pole catching the last of the light. On the opposite side, a merchant with silver streaked hair sits at a tavern table with a cup that never seems to empty.

The Barber is a thin and a fidgety man with nimble fingers and has restless eyes. He has the barber's habit of talking to fill silence, or to play the role of an unsolicited therapist. You can try and ask him about the proclamation.

The merchant is a broad, well dressed man who seems entirely too comfortable for someone living in a city with a monster problem. He has the look of a man who has learned that gold can buy distance from most troubles. You can try and ask him about the proclamation.

On the wall at the northern end of the market, near the palace gate, someone has scratched a crude calendar into the stone. Fourteen years worth of marks, each month noted. And beside the seventh year, a different mark, a rough shape like a curled, sleeping figure, and beside it an arrow pointing east. Toward the palace.

>go south
Herbalist's Shop
A low building that smells of dried things like herbs, roots, something sharper beneath. Bundles of plants hang from every rafter.

The herbalist is a small woman of indeterminate age. Her hands are stained with various dyes and preparations, and she does not look up from her work when you enter. You should ask her about the monster.

There is a black potion here. Small dark vial stoppered with wax. It smells faintly of something rotten.

There is another potion in small amber vial. It smells sharp and clean.

>ask her about it
She looks up at last.

"Velerad's witcher.". She says it flatly. "I know what you need. A Black Blood potion. Toxic to things that feed on human blood. They bite the drinker, they suffer for it.". She sets a small dark vial on the counter. "And Cat. For the dark. The palace vaults have no lanterns.". She adds a second vial, this one amber. You know the last one off course... The Black Blood is important, if the striga bites you, the poison passes to it. Slows it. It will not kill the creature, but it will weaken it." She names a price. It is not unreasonable. "Take both," she says. "Come back alive so I know if they worked."

>take cat potion
You pocket the Cat potion. You will drink it before you go in.

>take black potion
You pocket the Black Blood potion carefully.

>go north
Market Square
The market is winding down for the evening. Stall holders roll up their cloth and argue over the day's takings. At the far end, a barber is still open, with his red and white pole catching the last of the light. On the opposite side, a merchant with silver streaked hair sits at a tavern table with a cup that never seems to empty.

The Barber is a thin and a fidgety man with nimble fingers and has restless eyes. He has the barber's habit of talking to fill silence, or to play the role of an unsolicited therapist. You can try and ask him about the proclamation.

The merchant is a broad, well dressed man who seems entirely too comfortable for someone living in a city with a monster problem. He has the look of a man who has learned that gold can buy distance from most troubles. You can try and ask him about the proclamation.

On the wall at the northern end of the market, near the palace gate, someone has scratched a crude calendar into the stone. Fourteen years worth of marks, each month noted. And beside the seventh year, a different mark, a rough shape like a curled, sleeping figure, and beside it an arrow pointing east. Toward the palace.

>go east
The palace gate stands open, as Velerad promised. The guards watch you go through without a word. One of them makes a sign against evil behind your back. You do not turn around.

Inside the courtyard, the silence hits you first. No insects. No birds. Nothing wants to be near this place after dark. Maybe you should prepare... check your swords and magical signs. Don't forget the curse!

Ruined Courtyard
The palace courtyard is a ruin. Weeds push through the paving. A fountain has long since gone dry, its basin full of dead leaves. The main doors of the palace hang open and they have not been properly closed in years. The windows above are dark. Something has broken most of them from the inside. It is very quiet. The main hall waits ahead.

There is a stone fountain, ornate once, now cracked and dry. The basin is filled with old leaves and what might be old bloodstains, gone brown.

The upper windows of the palace are all broken, most from the inside, and shards of old glass lie on the ledges and the courtyard below.

>go north
Old Palace Hall
The main hall is vast and hollow. Moonlight falls through the broken roof in pale columns, lighting nothing useful. Dust on the floor, disturbed in a path that leads from the far end of the hall, from the direction of the stairs going down, and across to the main doors. The path of something that moves on all fours, and then on two legs, and then on all fours again. The stairs to the vault are at the far end, going down. It is quiet. She is still below.

There is a trail worn into the dust of the floor, leading from the vault stairs to the main doors.

>go down
Palace Vaults
The stairs end in darkness. Absolute darkness. You stop on the bottom step and hold still, letting your other senses work. The air is cold. Old. A smell like stone and something that has been alive a long time in a confined space. The floor is grit and old dust beneath your boots. You can hear the shape of the vault in the way sound does not travel. You cannot see. You move carefully.

Somewhere in your right, east, in the dark, something breathes very slowly.

>wait
You wait for the unexpected... yet you remain still. Why?

>wait
You wait for the unexpected... yet you remain still. Why?

Something moves in the dark ahead of you. The slow breathing stops. Stone grinds on stone. Then comes a sound you have no name for. The air shifts, and something starts entering the corridor. Move toward the sound, unless you mean to die. You have the disadvantage in the corridor.

>eat cat potion
You try to identify where the sound is coming from. You move very slowly, but before you have time to react, you see claws driving straight into your face. You fall to the ground, seeing only pitch black. You cannot breathe; your throat has been slashed by the monster's nails.

    *** Do you like being late? You should have taken the cat potion right from the start! ***

Would you like to RESTART, RESTORE a saved game, QUIT or UNDO the last command?

* * *

>check it
You get closer and see that it is a proclamation, signed by Foltest, King of Temeria, Pontar and Mahakam... You might want to examine it further to read the details.

* * *

>ask barber about it
The barber sets his razor down and leans forward. "You're here about the monster, aren't you? I can always tell. The eyes. And the swords, obviously." He lowers his voice to a theatrical whisper. "I'll tell you something no one else will. The creature... it was a child once. The king's daughter. Born of a cursed union, they say. The queen died in childbirth, and on that same night, the wise woman who came to deliver the girl laid a curse on her. Said she would not rest easy in death."

He picks up his razor again, examining the edge.

"Seven years she lay quiet in the crypt below the palace. Then she woke. Not herself. Not human." He draws a finger across his throat. "They sealed the palace after that. But she gets out sometimes. Into the district. People die."

>ask silk about it
The merchant looks you over with frank appraisal. "Silk," he says, offering his name like a coin. "I trade in fine goods. Or I did, before the palace business made this city a destination for the morbid and the desperate." He swirls his cup.

"You want to know about the monster. Everyone does." He leans back. "I was here when it first stirred. Seven years after the birth, as they say. I lost two good warehouse men that year. The thing comes out at night, crosses the district... But here is what I know that the others don't. It always returns before dawn. Always. Back to the crypt. Back to where it came from. I've watched."

He finishes his drink.

"I do not know why, but it returns every time, before the cock crows."

>check wall
Someone kept a record. The marks for the first seven years are faint. The marks after are deep, frantic, the scratching of a person who needed to remember. The curled figure and the eastern arrow are the last entry. No more marks after that.

You trace the marks with a finger. Seven years of nothing. Then the creature woke. The shape beside the seventh year mark, curled, like something sleeping. It rested in the crypt for seven years before it stirred. And the arrow east. Toward the palace. Toward the vaults below it.

You already know where you must go.

>go north
Castle Keep
The castle is old and smells of damp stone and old candles. Guards eye you at the gate but let you pass. They know the look of someone who has come about the contract. Inside, the keep is dim, the tapestries faded. Velerad's office is at the end of the main corridor.

Velerad is a heavyset man in his fifties with a soldier's posture and a bureaucrat's tired eyes. He sits behind a broad desk covered in papers.

A rolled map of the palace district lies on the corner of Velerad's desk.

A stiff parchment with Velerad's seal and the terms of the commission.

* * *

>sign it
You sign your mark at the bottom of the contract. Velerad passes the ink and nods. "Good. The palace gate will be unlocked for you tonight. Do not go in before dark. The guards have orders to let no one through during the day. The creature sleeps, and we want it to stay that way until you are ready. One more thing. There is a herbalist on the south side of the market. She may have something useful for you." He writes a name on a slip of paper and hands it to you. "Mention my name."

>go south
Market Square
The market is winding down for the evening. Stall holders roll up their cloth and argue over the day's takings. At the far end, a barber is still open, with his red and white pole catching the last of the light. On the opposite side, a merchant with silver streaked hair sits at a tavern table with a cup that never seems to empty.

The Barber is a thin and a fidgety man with nimble fingers and has restless eyes. He has the barber's habit of talking to fill silence, or to play the role of an unsolicited therapist. 

The merchant is a broad, well dressed man who seems entirely too comfortable for someone living in a city with a monster problem. He has the look of a man who has learned that gold can buy distance from most troubles. 

On the wall at the northern end of the market, near the palace gate, someone has scratched a crude calendar into the stone. Fourteen years worth of marks, each month noted. And beside the seventh year, a different mark, a rough shape like a curled, sleeping figure, and beside it an arrow pointing east. Toward the palace.

>go south
Herbalist's Shop
A low building that smells of dried things like herbs, roots, something sharper beneath. Bundles of plants hang from every rafter.

The herbalist is a small woman of indeterminate age. Her hands are stained with various dyes and preparations, and she does not look up from her work when you enter. You should ask her about the monster.

There is a black potion here. Small dark vial stoppered with wax. It smells faintly of something rotten.

There is another potion in small amber vial. It smells sharp and clean.

>ask herbalist about it
She looks up at last.

"Velerad's witcher.". She says it flatly. "I know what you need. A Black Blood potion. Toxic to things that feed on human blood. They bite the drinker, they suffer for it.". She sets a small dark vial on the counter. "And Cat. For the dark. The palace vaults have no lanterns.". She adds a second vial, this one amber. You know the last one off course... The Black Blood is important, if the striga bites you, the poison passes to it. Slows it. It will not kill the creature, but it will weaken it." She names a price. It is not unreasonable. "Take both," she says. "Come back alive so I know if they worked."

>ask her about it
She looks up at last.

"Velerad's witcher.". She says it flatly. "I know what you need. A Black Blood potion. Toxic to things that feed on human blood. They bite the drinker, they suffer for it.". She sets a small dark vial on the counter. "And Cat. For the dark. The palace vaults have no lanterns.". She adds a second vial, this one amber. You know the last one off course... The Black Blood is important, if the striga bites you, the poison passes to it. Slows it. It will not kill the creature, but it will weaken it." She names a price. It is not unreasonable. "Take both," she says. "Come back alive so I know if they worked."

>ask her about it
She looks up at last.

"Velerad's witcher.". She says it flatly. "I know what you need. A Black Blood potion. Toxic to things that feed on human blood. They bite the drinker, they suffer for it.". She sets a small dark vial on the counter. "And Cat. For the dark. The palace vaults have no lanterns.". She adds a second vial, this one amber. You know the last one off course... The Black Blood is important, if the striga bites you, the poison passes to it. Slows it. It will not kill the creature, but it will weaken it." She names a price. It is not unreasonable. "Take both," she says. "Come back alive so I know if they worked."

>take it
You pocket the Cat potion. You will drink it before you go in.

>take black potion
You pocket the Black Blood potion carefully.

>inventory
You are carrying:
  a Black Blood Potion
  a Cat Potion
  a Room Key
  a Proclamation
  a Silver Sword
  an Iron Sword
  a Magical Signs Tome

>go north
Market Square
The market is winding down for the evening. Stall holders roll up their cloth and argue over the day's takings. At the far end, a barber is still open, with his red and white pole catching the last of the light. On the opposite side, a merchant with silver streaked hair sits at a tavern table with a cup that never seems to empty.

The Barber is a thin and a fidgety man with nimble fingers and has restless eyes. He has the barber's habit of talking to fill silence, or to play the role of an unsolicited therapist. 

The merchant is a broad, well dressed man who seems entirely too comfortable for someone living in a city with a monster problem. He has the look of a man who has learned that gold can buy distance from most troubles. 

On the wall at the northern end of the market, near the palace gate, someone has scratched a crude calendar into the stone. Fourteen years worth of marks, each month noted. And beside the seventh year, a different mark, a rough shape like a curled, sleeping figure, and beside it an arrow pointing east. Toward the palace.

>go east
The palace gate stands open, as Velerad promised. The guards watch you go through without a word. One of them makes a sign against evil behind your back. You do not turn around.

Inside the courtyard, the silence hits you first. No insects. No birds. Nothing wants to be near this place after dark. Maybe you should prepare... check your swords and magical signs. Don't forget the curse!

Ruined Courtyard
The palace courtyard is a ruin. Weeds push through the paving. A fountain has long since gone dry, its basin full of dead leaves. The main doors of the palace hang open and they have not been properly closed in years. The windows above are dark. Something has broken most of them from the inside. It is very quiet. The main hall waits ahead.

There is a stone fountain, ornate once, now cracked and dry. The basin is filled with old leaves and what might be old bloodstains, gone brown.

The upper windows of the palace are all broken, most from the inside, and shards of old glass lie on the ledges and the courtyard below.

* * *

>go north
Old Palace Hall
The main hall is vast and hollow. Moonlight falls through the broken roof in pale columns, lighting nothing useful. Dust on the floor, disturbed in a path that leads from the far end of the hall, from the direction of the stairs going down, and across to the main doors. The path of something that moves on all fours, and then on two legs, and then on all fours again. The stairs to the vault are at the far end, going down. It is quiet. She is still below.

There is a trail worn into the dust of the floor, leading from the vault stairs to the main doors.

>save
Save failed.

>go down
Palace Vaults
The stairs end in darkness. Absolute darkness. You stop on the bottom step and hold still, letting your other senses work. The air is cold. Old. A smell like stone and something that has been alive a long time in a confined space. The floor is grit and old dust beneath your boots. You can hear the shape of the vault in the way sound does not travel. You cannot see. You move carefully.

Somewhere in your right, east, in the dark, something breathes very slowly.

>drink cat-potion
You can't see any such thing.

>drink cat potion
There's nothing suitable to drink here.

>inventory
You are carrying:
  a Black Blood Potion
  a Cat Potion
  a Room Key
  a Proclamation
  a Silver Sword
  an Iron Sword
  a Magical Signs Tome

Something moves in the dark ahead of you. The slow breathing stops. Stone grinds on stone. Then comes a sound you have no name for. The air shifts, and something starts entering the corridor. Move toward the sound, unless you mean to die. You have the disadvantage in the corridor.

>eat cat potion
You uncork the Cat potion and drink it in one swallow. Bitter as ash. For a moment the world dims, and then snaps back sharper than before. The dark is grey instead of black, shapes clear and distinct. You can see. Your cat eyes... are different.

Now you can see... The stairs end in grey half-light. The cat potion does its work. The vault is a long, low corridor with a stoned floor. Several chambers open off it. The eastern chamber lies at the far end. The air is cold and carries something that is not rot and not animal but is both and neither.

>wait
You wait for the unexpected... yet you remain still. Why?

>wait
You wait for the unexpected... yet you remain still. Why?

>go east
Before you can react, she moves faster than you expected. You see red. You cannot breathe. You do not feel the ground.

    *** You died. A Witcher is always prepared. Learn your signs, choose wisely, and do not hesitate. ***

Would you like to RESTART, RESTORE a saved game, QUIT or UNDO the last command?

>RESTORE
Restore failed.

Would you like to RESTART, RESTORE a saved game, QUIT or UNDO the last command?

* * *

>check wad
You get closer and see that it is a proclamation, signed by Foltest, King of Temeria, Pontar and Mahakam... You might want to examine it further to read the details.

>examine wad
You read the proclamation carefully:

"BY ORDER OF KING FOLTEST OF TEMERIA

Let it be known to all citizens of Wyzim and its surroundings:

The palace district is hereby forbidden to all persons, by penalty of death. None shall enter, none shall linger after dark.

A creature of unknown nature dwells within the old palace vaults. It is dangerous. It kills. Fourteen years have passed since the curse was laid and seven since it first stirred.

His Majesty King Foltest, in his mercy, forbids any attempt upon the creature's life.

His Majesty hereby calls upon any man of skill and knowledge, witcher, sorcerer, or wise man, who believes themselves capable of lifting the curse upon the creature, to present themselves before the castellan Velerad at Wyzim.

Any man or woman capable of lifting the curse without harm to the creature shall be rewarded handsomely by the crown with three thousand oren.

Those who attempt to destroy the creature instead of breaking the spell will be tried for treason."

You think about pulling it off in case you need to ask about it.

>pull it off
I only understood you as far as wanting to pull the Proclamation.

>pull the Proclamation
You pull the leather off the wood, roll it up and tuck it into your jerkin. This certainly will be useful later.

>go north
You push the door open and step inside.

Old Narakort Inn
You step inside. The smell of ale and sweat hits you first. The room is loud and packed. Farmers, merchants, a few armed men. The conversation dies the moment you cross the threshold. Every pair of eyes is on you. On your swords... On your eyes... Someone mutters something. Then another voice, louder: "We don't want your kind here, witcher."

You can drink, wait for something, even move or stay put. You think about leaving so you don't get into a fight for nothing.

A group of men sit hunched over their tankards, watching you with open hostility.

>go south
You step back out into the street.

Crossroads
You stand in front of the Old Narakort Inn, facing north. You spend a few seconds looking at the entrance, listening to the hubbub of voices. The Inn is full of people who may get the wrong impression of you. Farther down the street there is a smaller inn named The Fox, facing south. It is quite empty. You think about a contract you could make and a place to sleep when the night falls. Maybe a quiet place is a good option.

>go north
You push the door open and step inside.

Old Narakort Inn
You step inside. The smell of ale and sweat hits you first. The room is loud and packed. Farmers, merchants, a few armed men. The conversation dies the moment you cross the threshold. Every pair of eyes is on you. On your swords... On your eyes... Someone mutters something. Then another voice, louder: "We don't want your kind here, witcher."

You can drink, wait for something, even move or stay put. You think about leaving so you don't get into a fight for nothing.

A group of men sit hunched over their tankards, watching you with open hostility.

>stay put
I only understood you as far as wanting to stay.

>stay
Before you can settle in, two large men grab you by the arms and haul you toward the door. "Get out, freak," one of them growls. You do not resist. There is nothing here worth a fight.

You are back on the street.

Crossroads
You stand in front of the Old Narakort Inn, facing north. You spend a few seconds looking at the entrance, listening to the hubbub of voices. The Inn is full of people who may get the wrong impression of you. Farther down the street there is a smaller inn named The Fox, facing south. It is quite empty. You think about a contract you could make and a place to sleep when the night falls. Maybe a quiet place is a good option.

>go south
You push open the door of The Fox. The hinges creak. Inside, it is dim and quiet. Just the way you like it.

Fox Inn
The Fox is quiet. A few candles burn low on the tables. The innkeeper glances up at you without alarm. He has seen worse, or at least pretends he has. This will do. The innkeeper eyes the hilt of your sword and then your face. He opens his mouth, thinks better of it, closes it again. He looks like a man with something heavy on his chest.

The innkeeper is a broad-shouldered man with a trimmed grey beard and careful eyes. He keeps his hands on the bar, easy and visible. You can ask for a room to stay the night.  Or you could ask about the proclamation...

>ask about the proclamation
You can't see any such thing.

>ask the inkeeper about the proclamation
You can't see any such thing.

>ask the innkeeper about the proclamation
The innkeeper studies you a moment, then sets down the rag he was using to wipe the bar. "You're a witcher, aren't you?" He does not wait for an answer. "I can always tell. The eyes... You... That white hair. Also the medallion. A wolf... from Kaer Mor... Something like that. You know, one called Vesemir had hair almost like yours. Maybe I should not ask about it. A lot of witchers pass here and some talk and I listen." He pours a cup of something dark and slides it across the counter without being asked. "I'll not throw you out," he says. "A man's coin is a man's coin. But..." He hesitates. "Have you seen the proclamation?"

He glances toward the door before he speaks again. You think on asking about the proclamation...
The innkeeper lowers his voice. "The proclamation on the gate. I expect you read it." He glances around the empty room, habit more than caution. "Fourteen years ago a curse fell on the old palace. The creature that lives in the vaults... folks say it is a terrible monster. A cursed thing, half woman, half beast. Kills without reason. Velerad, the king's castellan, he is the one offering the contract. His office is in the castle keep, north through the market. This market is not far from my inn. You should get there easily by just going east from here."

He refills your cup."I'll give you a room, witcher. Cheapest in Wyzim. Consider it goodwill. We could use someone who isn't afraid of that thing." He slides a key across the worn wood of the bar. You scoop it up, feeling the cold iron against your palm, and secure it in your pocket.

>go east
Market Square
The market is winding down for the evening. Stall-holders roll up their cloth and argue over the day's takings. At the far end, a barber is still open, his red-and-white pole catching the last of the light. On the opposite side, a merchant with silver-streaked hair sits at a tavern table with a cup that never seems to empty.

The Barber is thin and a fidgety man with nimble fingers and restless eyes. He has the barber's habit of talking to fill silence, or to play the role of an unsolicited therapist. You can try and ask him about the proclamation.

The merchant is a broad, well-dressed man who seems entirely too comfortable for someone living in a city with a monster problem. He has the look of a man who has learned that gold can buy distance from most troubles. You can try and aks him about the proclamation.

On the wall at the northern end of the market, near the palace gate, someone has scratched a crude calendar into the stone. Fourteen years worth of marks, each month noted. And beside the seventh year, a different mark, a rough shape like a curled, sleeping figure, and beside it an arrow pointing east. Toward the palace.

>go west
You push open the door of The Fox. The hinges creak. Inside, it is dim and quiet. Just the way you like it.

Fox Inn
The Fox is quiet. A few candles burn low on the tables. The innkeeper glances up at you without alarm. He has seen worse, or at least pretends he has. This will do. The innkeeper mentioned the castle. You should ask him more about it, or head there yourself. It lies north of this inn. Speak with Velerad. You could also try the market and ask around.

The innkeeper is a broad-shouldered man with a trimmed grey beard and careful eyes. He keeps his hands on the bar, easy and visible. You can ask for a room to stay the night.  Or you could ask about the proclamation...

>rest
You could sleep. But the proclamation sits in your jerkin like a stone. First, the castle. First, Velerad. You need that oren to eat and continue your journey. It is not that late so you can do a contract first before sleeping.

>go east
Market Square
The market is winding down for the evening. Stall-holders roll up their cloth and argue over the day's takings. At the far end, a barber is still open, his red-and-white pole catching the last of the light. On the opposite side, a merchant with silver-streaked hair sits at a tavern table with a cup that never seems to empty.

The Barber is thin and a fidgety man with nimble fingers and restless eyes. He has the barber's habit of talking to fill silence, or to play the role of an unsolicited therapist. You can try and ask him about the proclamation.

The merchant is a broad, well-dressed man who seems entirely too comfortable for someone living in a city with a monster problem. He has the look of a man who has learned that gold can buy distance from most troubles. You can try and aks him about the proclamation.

On the wall at the northern end of the market, near the palace gate, someone has scratched a crude calendar into the stone. Fourteen years worth of marks, each month noted. And beside the seventh year, a different mark, a rough shape like a curled, sleeping figure, and beside it an arrow pointing east. Toward the palace.

* * *

>enter
You must supply a noun.

>enter Old Narakort
You can't see any such thing.

* * *

>enter
You must supply a noun.

>enter it
That's not something you can enter.

* * *

>enter old narakort
You can't see any such thing.

>enter old narakort inn
You can't see any such thing.

>enter the old narakort inn
You can't see any such thing.

>enter in the old narakort inn
I only understood you as far as wanting to enter inside.

>enter in inn
I only understood you as far as wanting to enter inside.

* * *

>enter the old narakort
You can't see any such thing.

>go to the old narakort
You can't see any such thing.

>go the old narakort
You can't see any such thing.

* * *

>examine it
You get closer and see that it is a proclamation, signed by Foltest, King of Temeria, Pontar and Mahakam... You might want to examine it further to read the details.

>check
What do you want to check?

>check it
You read the proclamation carefully:

"BY ORDER OF KING FOLTEST OF TEMERIA

Let it be known to all citizens of Wyzim and its surroundings:

The palace district is hereby forbidden to all persons, by penalty of death. None shall enter, none shall linger after dark.

A creature of unknown nature dwells within the old palace vaults. It is dangerous. It kills. Fourteen years have passed since the curse was laid and seven since it first stirred.

His Majesty King Foltest, in his mercy, forbids any attempt upon the creature's life.

His Majesty hereby calls upon any man of skill and knowledge, witcher, sorcerer, or wise man, who believes themselves capable of lifting the curse upon the creature, to present themselves before the castellan Velerad at Wyzim.

Any man or woman capable of lifting the curse without harm to the creature shall be rewarded handsomely by the crown with three thousand oren.

Those who attempt to destroy the creature instead of breaking the spell will be tried for treason."

You think about pulling it off in case you need to ask about it.

* * *

>ask the innkeeper about the proclamation
The innkeeper studies you a moment, then sets down the rag he was using to wipe the bar.  "You're a witcher, aren't you?" He does not wait for an answer. "I can always tell. The eyes... You... That white hair. Also the medallion. A wolf... from Kaer Mor... Something like that. You know, one called Vesemir had hair almost like yours. Maybe I should not ask about it. A lot of witchers pass here and some talk and I listen." He pours a cup of something dark and slides it across the counter without being asked. "I'll not throw you out," he says. "A man's coin is a man's coin. But..." He hesitates. "Have you seen the proclamation?"

He glances toward the door before he speaks again.
The innkeeper lowers his voice. "The proclamation on the gate. I expect you read it." He glances around the empty room, habit more than caution. "Fourteen years ago a curse fell on the old palace. The creature that lives in the vaults... folks say it is a terrible monster. A cursed thing, half woman, half beast. Kills without reason. Velerad, the king's castellan, he is the one offering the contract. His office is in the castle keep, north through the market. This market is not far from my inn. You should get there easily by just going east from here."

He refills your cup."I'll give you a room, witcher. Cheapest in Wyzim. Consider it goodwill. We could use someone who isn't afraid of that thing." He slides a key across the worn wood of the bar. You scoop it up, feeling the cold iron against your palm, and secure it in your pocket.

>talk to innkeper
You can't see any such thing.

>talk to innkeeper
The innkeeper shrugs. "I've told you what I know. Velerad at the castle will know the rest. He's been living with this longer than any of us."

>go east
Market Square
The market is winding down for the evening. Stall holders roll up their cloth and argue over the day's takings. At the far end, a barber is still open, with his red and white pole catching the last of the light. On the opposite side, a merchant with silver streaked hair sits at a tavern table with a cup that never seems to empty.

The Barber is a thin and a fidgety man with nimble fingers and has restless eyes. He has the barber's habit of talking to fill silence, or to play the role of an unsolicited therapist. You can try and ask him about the proclamation.

The merchant is a broad, well dressed man who seems entirely too comfortable for someone living in a city with a monster problem. He has the look of a man who has learned that gold can buy distance from most troubles. You can try and ask him about the proclamation.

On the wall at the northern end of the market, near the palace gate, someone has scratched a crude calendar into the stone. Fourteen years worth of marks, each month noted. And beside the seventh year, a different mark, a rough shape like a curled, sleeping figure, and beside it an arrow pointing east. Toward the palace.

>ask the barber about the proclamation
The barber sets his razor down and leans forward. "You're here about the monster, aren't you? I can always tell. The eyes. And the swords, obviously." He lowers his voice to a theatrical whisper. "I'll tell you something no one else will. The creature... it was a child once. The king's daughter. Born of a cursed union, they say. The queen died in childbirth, and on that same night, the wise woman who came to deliver the girl laid a curse on her. Said she would not rest easy in death."

He picks up his razor again, examining the edge.

"Seven years she lay quiet in the crypt below the palace. Then she woke. Not herself. Not human." He draws a finger across his throat. "They sealed the palace after that. But she gets out sometimes. Into the district. People die."

>ask the mechant about it
You can't see any such thing.

>ask the merchant about it
The merchant looks you over with frank appraisal. "Silk," he says, offering his name like a coin. "I trade in fine goods. Or I did, before the palace business made this city a destination for the morbid and the desperate." He swirls his cup.

"You want to know about the monster. Everyone does." He leans back. "I was here when it first stirred. Seven years after the birth, as they say. I lost two good warehouse men that year. The thing comes out at night, crosses the district... But here is what I know that the others don't. It always returns before dawn. Always. Back to the crypt. Back to where it came from. I've watched."

He finishes his drink.

"I do not know why, but it returns every time, before the cock crows."

>check wall
Someone kept a record. The marks for the first seven years are faint. The marks after are deep, frantic, the scratching of a person who needed to remember. The curled figure and the eastern arrow are the last entry. No more marks after that.

You trace the marks with a finger. Seven years of nothing. Then the creature woke. The shape beside the seventh year mark, curled, like something sleeping. It rested in the crypt for seven years before it stirred. And the arrow east. Toward the palace. Toward the vaults below it.

You already know where you must go.

* * *

>go north
Castle Keep
The castle is old and smells of damp stone and old candles. Guards eye you at the gate but let you pass. They know the look of someone who has come about the contract. Inside, the keep is dim, the tapestries faded. Velerad's office is at the end of the main corridor.

Velerad is a heavyset man in his fifties with a soldier's posture and a bureaucrat's tired eyes. He sits behind a broad desk covered in papers.

A rolled map of the palace district lies on the corner of Velerad's desk.

A stiff parchment with Velerad's seal and the terms of the commission.

>examine map
Velerad whistles to you, with a wierd face that translates to something like "You come here and the first thing you do is looking at my belongings?".

>examine parchment
Velerad is not that happy. Is face is turning red. Maybe you should stop looking at his stuff before talking to him.

>examine parchment
Velerad is like: "This piece of sh**"... Maybe you should ask him about the proclamation first before signing the contract.

>ask velerad about it
Velerad watches your wandering eyes with theatrical exhaustion. "Tell me, do you usually paw, sniff, and salivate over a man's property before introducing yourself? Or is the olfactory inspection of my desk part of some secret Witcher ritual? Ahhh... Well..."

Velerad sets down his quill. "That medallion... A witcher. Good. Sit down." He does not wait to see if you will. "I am going to tell you everything, because the men I sent before you all died, and I am tired of burying good soldiers over a thing that might be fixed." He folds his hands.

"The creature is the king's daughter. Adda. Born under a curse laid by a wise woman at the birth. The circumstances I will not go into, they are... unpleasant, and irrelevant. For seven years she lay in the crypt below the palace, still. We thought the curse had come to nothing. Then she woke."

He stands and moves to a cabinet, pulling out a rolled map, which he sets flat on the desk. "The palace vaults below the old throne room. She lives there. The crypt has a sarcophagus, where she sleeps by day. At night she hunts. The king will not allow her to be killed, because she is his daughter. He believes the curse can be broken and I am... less certain. But those are my orders, and so I am offering three thousand oren to anyone who can lift it. A crazy old man once said that someone must spend the night with the thing until the cock crows for the third time. You should see what remains of him..." Velerad laughs. You know the old man was likely right. You've heard of this before. It is no wonder he died, however, as a striga is a formidable monster, even witchers struggle against one.

Velerad slides a document across the desk. It is the map that you already saw.

"The crypt lies below the palace, through the old throne room, down one flight. The sarcophagus is in the eastern vault. You will need to go at night. The creature only emerges at night. Witcher, do you know how to break a striga's curse? Well good luck because I don't and don't care. To me this monster should be killed, and if it comes to that Witcher..." Velerad starts laughing. "If you must, kill it, but i can't help you if it comes to that.". 

You have many details on how the monster behaves, and maybe how to break the curse. "Just one more thing Witcher! Sign the contract before you leave and I will tell you something usefull! Or just leave if you don't like contracts..."

>sign it
You sign your mark at the bottom of the contract. Velerad passes the ink and nods. "Good. The palace gate will be unlocked for you tonight. Do not go in before dark. The guards have orders to let no one through during the day. The creature sleeps, and we want it to stay that way until you are ready. One more thing. There is a herbalist on the south side of the market. She may have something useful for you." He writes a name on a slip of paper and hands it to you. "Mention my name."

* * *

>go south
Herbalist's Shop
A low building that smells of dried things like herbs, roots, something sharper beneath. Bundles of plants hang from every rafter.

The herbalist is a small woman of indeterminate age. Her hands are stained with various dyes and preparations, and she does not look up from her work when you enter. You should ask her about the monster.

There is a black potion here. Small dark vial stoppered with wax. It smells faintly of something rotten.

There is another potion in small amber vial. It smells sharp and clean.

>examine black potion
Maybe you should ask the herbalist about the monster first... No?

>ash herbalist about i
That's not a verb I recognise.

>ash herbalist about it
That's not a verb I recognise.

>ask herbalist
What do you want to ask the Herbalist for?

>ask herbalist about it
She looks up at last.

"Velerad's witcher.". She says it flatly. "I know what you need. A Black Blood potion. Toxic to things that feed on human blood. They bite the drinker, they suffer for it.". She sets a small dark vial on the counter. "And Cat. For the dark. The palace vaults have no lanterns.". She adds a second vial, this one amber. You know the last one off course... The Black Blood is important, if the striga bites you, the poison passes to it. Slows it. It will not kill the creature, but it will weaken it." She names a price. It is not unreasonable. "Take both," she says. "Come back alive so I know if they worked."

>take it
You pocket the Black Blood potion carefully.

>take it
You already have that.

>take cat potion
You pocket the Cat potion. You will drink it before you go in.

>go north
Market Square
The market is winding down for the evening. Stall holders roll up their cloth and argue over the day's takings. At the far end, a barber is still open, with his red and white pole catching the last of the light. On the opposite side, a merchant with silver streaked hair sits at a tavern table with a cup that never seems to empty.

The Barber is a thin and a fidgety man with nimble fingers and has restless eyes. He has the barber's habit of talking to fill silence, or to play the role of an unsolicited therapist. 

The merchant is a broad, well dressed man who seems entirely too comfortable for someone living in a city with a monster problem. He has the look of a man who has learned that gold can buy distance from most troubles. 

On the wall at the northern end of the market, near the palace gate, someone has scratched a crude calendar into the stone. Fourteen years worth of marks, each month noted. And beside the seventh year, a different mark, a rough shape like a curled, sleeping figure, and beside it an arrow pointing east. Toward the palace.

* * *

>check magical signs
The basic five witcher signs: Aard, Igni, Yrden, Quen, and Axii. You can examine further each sign.

>check magical aard
I only understood you as far as wanting to check the Magical Signs Tome.

>check aard
The Aard sign is comprised of a telekinetic thrust that can stun, repel, knock down, or disarm opponents, as well as remove barriers and other objects.

>go ahead
You can't see any such thing.

>go north
Old Palace Hall
The main hall is vast and hollow. Moonlight falls through the broken roof in pale columns, lighting nothing useful. Dust on the floor, disturbed in a path that leads from the far end of the hall, from the direction of the stairs going down, and across to the main doors. The path of something that moves on all fours, and then on two legs, and then on all fours again. The stairs to the vault are at the far end, going down. It is quiet. She is still below.

There is a trail worn into the dust of the floor, leading from the vault stairs to the main doors.

* * *

>go down
Palace Vaults
The stairs end in darkness. Absolute darkness. You stop on the bottom step and hold still, letting your other senses work. The air is cold. Old. A smell like stone and something that has been alive a long time in a confined space. The floor is grit and old dust beneath your boots. You can hear the shape of the vault in the way sound does not travel. You cannot see. You move carefully.

Somewhere in your right, east, in the dark, something breathes very slowly.

>go up
Old Palace Hall
The main hall is vast and hollow. Moonlight falls through the broken roof in pale columns, lighting nothing useful. Dust on the floor, disturbed in a path that leads from the far end of the hall, from the direction of the stairs going down, and across to the main doors. The path of something that moves on all fours, and then on two legs, and then on all fours again. The stairs to the vault are at the far end, going down. It is quiet. She is still below.

There is a trail worn into the dust of the floor, leading from the vault stairs to the main doors.

>take cat potion
You already have that.

>drink cat potion
There's nothing suitable to drink here.

>eat cat potion
You uncork the Cat potion and drink it in one swallow. Bitter as ash. For a moment the world dims, and then snaps back sharper than before. The dark is grey instead of black, shapes clear and distinct. You can see. Your cat eyes... are different.

>go down
Palace Vaults
The stairs end in grey half-light. The cat potion does its work. The vault is a long, low corridor with a stoned floor. Several chambers open off it. The eastern chamber lies at the far end. The air is cold and carries something that is not rot and not animal but is both and neither.

It is quiet. At the far end, in the eastern chamber, the sarcophagus waits.

>go east
Eastern Chamber
A stone chamber. In the centre stands the sarcophagus, a heavy grey stone, its lid displaced, scored with deep claw marks along every edge. The smell is strong here. Old. Wrong.She is in here. You can hear her. A low sound, not quite animal, closer to something in pain. Movement near the large stone object at the room's centre. She is not attacking. Not yet.

 There is a heavy stone sarcophagus with its lid partially displaced. The stone around the edges is scored with claw marks, deep and repetitive, the work of years.

The sarcophagus. She is inside it. You can hear her breathing, slow and deep, through the gap in the lid.

You see the heavy lid of the sarcophagus begin to slide. A pale, clawed hand hooks over the edge, and with a sudden, violent burst of strength, she flings herself out. She crouches on the stone floor, her eyes reflecting the faint light, fixed entirely on you. You will need to fight it. Remember what you have!
 The black potion can weaken it, but you need let her attack you.

>fight it
With you silver sword drawn, you push yourself further, with agile movements. You swing the silver sword in a wide arc. The blade catches her across the shoulder and she screams, a sound that is half animal, half something older and worse. Silver burns her and you can see it in the way she flinches back. Although she is screaming you notice that she is not weak... You need to weaken her somehow.
Somehow you must survive until dawn with that beast. But how? Is there somewhere to hide? Somewhere you might use a sign to your advantage?

>atack the thing
That's not a verb I recognise.

>attack the thing
Violence isn't the answer to this one.

>attack the creature
You can't see any such thing.

>go south
You can't go that way.

>go west
Palace Vaults
The stairs end in grey half-light. The cat potion does its work. The vault is a long, low corridor with a stoned floor. Several chambers open off it. The eastern chamber lies at the far end. The air is cold and carries something that is not rot and not animal but is both and neither.

>RESTORE
Restore failed.

>RESTART
Are you sure you want to restart?

>examine it
Please answer yes or no.

>see it
Please answer yes or no.

>take it
Please answer yes or no.

>go south
Please answer yes or no.

>ask innkeeper about it
Please answer yes or no.

>go east
Please answer yes or no.

>go north
Please answer yes or no.

>ask velerad about it
Please answer yes or no.

>go south
Please answer yes or no.

>go south
Please answer yes or no.

>ask her about it
Please answer yes or no.

>ask herbalist about it
Please answer yes or no.

>take black potion
Please answer yes or no.

>take cat potion
Please answer yes or no.

>go south
Please answer yes or no.

>go north
Please answer yes or no.

>go east
Please answer yes or no.

* * *

>go north
Please answer yes or no.

>eat cat potion
Please answer yes or no.

>go down
Please answer yes or no.

>go east
Please answer yes or no.

>examine it
Please answer yes or no.

>attack it
Please answer yes or no.

* * *

>examine it
You get closer and see that it is a proclamation, signed by Foltest, King of Temeria, Pontar and Mahakam... You might want to examine it further to read the details.

>examine it
You read the proclamation carefully:

"BY ORDER OF KING FOLTEST OF TEMERIA

Let it be known to all citizens of Wyzim and its surroundings:

The palace district is hereby forbidden to all persons, by penalty of death. None shall enter, none shall linger after dark.

A creature of unknown nature dwells within the old palace vaults. It is dangerous. It kills. Fourteen years have passed since the curse was laid and seven since it first stirred.

His Majesty King Foltest, in his mercy, forbids any attempt upon the creature's life.

His Majesty hereby calls upon any man of skill and knowledge, witcher, sorcerer, or wise man, who believes themselves capable of lifting the curse upon the creature, to present themselves before the castellan Velerad at Wyzim.

Any man or woman capable of lifting the curse without harm to the creature shall be rewarded handsomely by the crown with three thousand oren.

Those who attempt to destroy the creature instead of breaking the spell will be tried for treason."

You think about pulling it off in case you need to ask about it.

>pull it
You pull the leather off the wood, roll it up and tuck it into your jerkin. This certainly will be useful later.

>examine it
You read the proclamation carefully:

"BY ORDER OF KING FOLTEST OF TEMERIA

Let it be known to all citizens of Wyzim and its surroundings:

The palace district is hereby forbidden to all persons, by penalty of death. None shall enter, none shall linger after dark.

A creature of unknown nature dwells within the old palace vaults. It is dangerous. It kills. Fourteen years have passed since the curse was laid and seven since it first stirred.

His Majesty King Foltest, in his mercy, forbids any attempt upon the creature's life.

His Majesty hereby calls upon any man of skill and knowledge, witcher, sorcerer, or wise man, who believes themselves capable of lifting the curse upon the creature, to present themselves before the castellan Velerad at Wyzim.

Any man or woman capable of lifting the curse without harm to the creature shall be rewarded handsomely by the crown with three thousand oren.

Those who attempt to destroy the creature instead of breaking the spell will be tried for treason."

* * *

>pull it
You pull the leather off the wood, roll it up and tuck it into your jerkin. This certainly will be useful later.

>go north
You push the door open and step inside.

Old Narakort Inn
You step inside. The smell of ale and sweat hits you first. The room is loud and packed. Farmers, merchants, a few armed men. The conversation dies the moment you cross the threshold. Every pair of eyes is on you. On your swords... On your eyes... Someone mutters something. Then another voice, louder: "We don't want your kind here, witcher."

You can drink, wait for something, even move or stay put. You think about leaving so you don't get into a fight for nothing.

A group of men sit hunched over their tankards, watching you with open hostility.

>stay
Before you can settle in, two large men grab you by the arms and haul you toward the door. "Get out, freak," one of them growls. You do not resist. There is nothing here worth a fight.

You are back on the street.

Crossroads
You stand in front of the Old Narakort Inn, facing north. You spend a few seconds looking at the entrance, listening to the hubbub of voices. The Inn is full of people who may get the wrong impression of you. Farther down the street there is a smaller inn named The Fox, facing south. It is quite empty. You think about a contract you could make and a place to sleep when the night falls. Maybe a quiet place is a good option.

>go south
You push open the door of The Fox. The hinges creak. Inside, it is dim and quiet. Just the way you like it.

The innkeeper studies you a moment, then sets down the rag he was using to wipe the bar. "You're a witcher, aren't you?" He does not wait for an answer. "I can always tell. The eyes. You... That white hair. You know, one called Vesemir had hair almost like yours. Maybe I should not ask about it." He pours a cup of something dark and slides it across the counter without being asked. "I'll not throw you out," he says. "A man's coin is a man's coin. But..." He hesitates. "You've seen the proclamation?"

He glances toward the door before he speaks again.

>speak
I didn't understand that sentence.

>examine it
You see nothing unexpected in that direction.

>examine innkeeper
His face is creased with the kind of worry that comes from years of hearing bad news. He watches you the way a man watches a fire he is not sure he can control.

* * *

>go south
Herbalist's Shop
A low building that smells of dried things like herbs, roots, something sharper beneath. Bundles of plants hang from every rafter.

The herbalist is a small woman of indeterminate age. Her hands are stained with various dyes and preparations, and she does not look up from her work when you enter. You should ask her about the monster.

There is a black potion here. Small dark vial stoppered with wax. It smells faintly of something rotten.

There is another potion in small amber vial. It smells sharp and clean.

>ask her about it
She looks up at last.

"Velerad's witcher.". She says it flatly. "I know what you need. A Black Blood potion. Toxic to things that feed on human blood. They bite the drinker, they suffer for it.". She sets a small dark vial on the counter. "And Cat. For the dark. The palace vaults have no lanterns.". She adds a second vial, this one amber. You know the last one off course... The Black Blood is important, if the striga bites you, the poison passes to it. Slows it. It will not kill the creature, but it will weaken it." She names a price. It is not unreasonable. "Take both," she says. "Come back alive so I know if they worked.

 You should follow what she says. Take both potions and examine them."

>take cat potion
You pocket the Cat potion. You will drink it before you go in.

* * *

>take black potion
You pocket the Black Blood potion carefully.

>examine cat potion
A witcher's preparation that enhances sight in darkness. It is surprising that this herbalist sells this.

>examine black potion
A preparation toxic to creatures that feed on human blood. If they bite you while it is in your system, the poison transfers. The herbalist said it would weaken the striga, not kill it. That is exactly what you want.

>go north
Market Square
The market is winding down for the evening. Stall holders roll up their cloth and argue over the day's takings. At the far end, a barber is still open, with his red and white pole catching the last of the light. On the opposite side, a merchant with silver streaked hair sits at a tavern table with a cup that never seems to empty.

The Barber is a thin and a fidgety man with nimble fingers and has restless eyes. He has the barber's habit of talking to fill silence, or to play the role of an unsolicited therapist. 

The merchant is a broad, well dressed man who seems entirely too comfortable for someone living in a city with a monster problem. He has the look of a man who has learned that gold can buy distance from most troubles. 

On the wall at the northern end of the market, near the palace gate, someone has scratched a crude calendar into the stone. Fourteen years worth of marks, each month noted. And beside the seventh year, a different mark, a rough shape like a curled, sleeping figure, and beside it an arrow pointing east. Toward the palace.

* * *

>go down
Palace Vaults
The stairs end in darkness. Absolute darkness. You stop on the bottom step and hold still, letting your other senses work. The air is cold. Old. A smell like stone and something that has been alive a long time in a confined space. The floor is grit and old dust beneath your boots. You can hear the shape of the vault in the way sound does not travel. You cannot see. You move carefully.

Somewhere in your right, east, in the dark, something breathes very slowly.

>drink cat potion
You uncork the Cat potion and drink it in one swallow. Bitter as ash. For a moment the world dims, and then snaps back sharper than before. The dark is grey instead of black, shapes clear and distinct. You can see. Your cat eyes... are different.

Now you can see... The stairs end in grey half-light. The cat potion does its work. The vault is a long, low corridor with a stoned floor. Several chambers open off it. The eastern chamber lies at the far end. The air is cold and carries something that is not rot and not animal but is both and neither.

>eat cat potion
You can't see any such thing.

>go east
Eastern Chamber
A stone chamber. In the centre stands the sarcophagus, a heavy grey stone, its lid displaced, scored with deep claw marks along every edge. The smell is strong here. Old. Wrong.She is in here. You can hear her. A low sound, not quite animal, closer to something in pain. Movement near the large stone object at the room's centre. She is not attacking. Not yet.

 There is a heavy stone sarcophagus with its lid partially displaced. The stone around the edges is scored with claw marks, deep and repetitive, the work of years.

The sarcophagus. She is inside it. You can hear her breathing, slow and deep, through the gap in the lid.

You see the heavy lid of the sarcophagus begin to slide. A pale, clawed hand hooks over the edge, and with a sudden, violent burst of strength, she flings herself out. She crouches on the stone floor, her eyes reflecting the faint light, fixed entirely on you. You will need to fight it. Remember what you have!
 The black potion can weaken it, but you need let her attack you.

>examine it
 

The sarcophagus sits at the far end of the chamber. Stone, old, the lid slightly askew. She has been moving it from the inside. The air around it is colder than the rest of the vault.

>aard
You cast Aard. The Striga is hurled several meters back, buying you a moment to think. You need to weaken her somehow.
Somehow you must survive until dawn with that beast. But how? Is there somewhere to hide? Somewhere you might use a sign to your advantage?
You still have the Black Blood Potion. You remember what the herbalist told you... Perhaps you should drink it and let her come to you.

>hide in sarcophagus
In a flash, a thought cuts through the noise. The sarcophagus... it is open. You catch it from the corner of your eye. You run to it and climb in, pulling the lid over yourself. But she is already on top of it. With one heavy movement she tears the lid away and, faster than you can follow, opens your throat. You feel nothing. Not even when she picks you up and throws you across the room. The red comes first. Then the dark.

    *** You died a horrible death. Just like the old man Velerad mentioned. You need to weaken the creature first. Did you speak to the beautiful herbalist? Wait, do you even know her? Did you get that strange potion from her? ***

Would you like to RESTART, RESTORE a saved game, QUIT or UNDO the last command?

* * *

>pull it
You pull the leather off the wood, roll it up and tuck it into your jerkin. This certainly will be useful later.

>pull it
You already have that.

* * *

>pull it
You pull the leather off the wood, roll it up and tuck it into your jerkin. This certainly will be useful later.

>take it
You pull the leather off the wood, roll it up and tuck it into your jerkin. You might want to read it carefully later.

* * *

>pull proclamation
You pull the leather off the wood, roll it up and tuck it into your jerkin. You might want to read it carefully later.

>pull it
Nothing obvious happens.

>take it
You pull the leather off the wood, roll it up and tuck it into your jerkin. You might want to read it carefully later.

* * *

>take it
You pull the leather off the wood, roll it up and tuck it into your jerkin. This certainly will be useful later.

>go south
You push open the door of The Fox. The hinges creak. Inside, it is dim and quiet. Just the way you like it.

Fox Inn
The Fox is quiet. A few candles burn low on the tables. The innkeeper glances up at you without alarm. He has seen worse, or at least pretends he has. This will do. The innkeeper eyes the hilt of your sword and then your face. He opens his mouth, thinks better of it, closes it again. He looks like a man with something heavy on his chest.

The innkeeper is a broad-shouldered man with a trimmed grey beard and careful eyes. He keeps his hands on the bar, easy and visible. You can ask for a room to stay the night.  Or you could ask about the proclamation...

* * *

>go east
Market Square
The market is winding down for the evening. Stall holders roll up their cloth and argue over the day's takings. At the far end, a barber is still open, with his red and white pole catching the last of the light. On the opposite side, a merchant with silver streaked hair sits at a tavern table with a cup that never seems to empty.

The Barber is a thin and a fidgety man with nimble fingers and has restless eyes. He has the barber's habit of talking to fill silence, or to play the role of an unsolicited therapist. You can try and ask him about the proclamation.

The merchant is a broad, well dressed man who seems entirely too comfortable for someone living in a city with a monster problem. He has the look of a man who has learned that gold can buy distance from most troubles. You can try and ask him about the proclamation.

On the wall at the northern end of the market, near the palace gate, someone has scratched a crude calendar into the stone. Fourteen years worth of marks, each month noted. And beside the seventh year, a different mark, a rough shape like a curled, sleeping figure, and beside it an arrow pointing east. Toward the palace.

>go east
The palace gate stands closed. The guards notices you. "Hey you!" but you notice also that they are nervous or almost terrified. For sure they don't want to be there. They notice the two swords and say, "Oh... haha, well you are witcher aint you? We can let you pass but we will not check on you!" You go through without a word.

Inside the courtyard, the silence hits you first. No insects. No birds. Nothing wants to be near this place after dark. Maybe you should prepare before going further.

Ruined Courtyard
The palace courtyard is a ruin. Weeds push through the paving. A fountain has long since gone dry, its basin full of dead leaves. The main doors of the palace hang open and they have not been properly closed in years. The windows above are dark. Something has broken most of them from the inside. It is very quiet. The main hall waits ahead.

There is a stone fountain, ornate once, now cracked and dry. The basin is filled with old leaves and what might be old bloodstains, gone brown.

The upper windows of the palace are all broken, most from the inside, and shards of old glass lie on the ledges and the courtyard below.

>go north
Old Palace Hall
The main hall is vast and hollow. Moonlight falls through the broken roof in pale columns, lighting nothing useful. Dust on the floor, disturbed in a path that leads from the far end of the hall, from the direction of the stairs going down, and across to the main doors. The path of something that moves on all fours, and then on two legs, and then on all fours again. The stairs to the vault are at the far end, going down. It is quiet. She is still below.

There is a trail worn into the dust of the floor, leading from the vault stairs to the main doors.

>go down
Palace Vaults
The stairs end in darkness. Absolute darkness. You stop on the bottom step and hold still, letting your other senses work. The air is cold. Old. A smell like stone and something that has been alive a long time in a confined space. The floor is grit and old dust beneath your boots. You can hear the shape of the vault in the way sound does not travel. You cannot see. You move carefully.

Somewhere in your right, east, in the dark, something breathes very slowly.You hear her. Close. A sound between breathing and growling, just ahead in the dark. You cannot tell exactly where.

>wait
Time passes.

>wait
Time passes.

Something moves in the dark ahead of you. The slow breathing stops. Stone grinds on stone. Then there is a sound you have no name for, and the air moves, and something is in the corridor with you.

>go east
You try to identify where the sound is coming from. You move very slowly, but before you have time to react, you see claws driving straight into your face. You fall to the ground, seeing only pitch black. You cannot breathe; your throat has been slashed by the monster's nails.

    *** You should have prepared more... Witchers are always cautious and keep a Cat Potion with them at all times. You should explore further to find a herbalist. ***

Would you like to RESTART, RESTORE a saved game, QUIT or UNDO the last command?

* * *

>examine it
You get closer and see that it is a proclamation, signed by Foltest, King of Temeria, Pontar and Mahakam... You might want to examine it further to read the details.

>examine proclamation
You read the proclamation carefully:

BY ORDER OF KING FOLTEST OF TEMERIA

Let it be known to all citizens of Wyzim and its surroundings:

The palace district is hereby forbidden to all persons, by penalty of death. None shall enter, none shall linger after dark.

A creature of unknown nature dwells within the old palace vaults. It is dangerous. It kills. Fourteen years have passed since the curse was laid and seven since it first stirred.

His Majesty King Foltest, in his mercy, forbids any attempt upon the creature's life.

His Majesty hereby calls upon any man of skill and knowledge, witcher, sorcerer, or wise man, who believes themselves capable of lifting the curse upon the creature, to present themselves before the castellan Velerad at Wyzim.

Any man or woman capable of lifting the curse without harm to the creature shall be rewarded handsomely by the crown with three thousand oren.

Those who attempt to destroy the creature instead of breaking the spell will be tried for treason.

You think about peeling it off in case you need to ask about it.

* * *

>examine it
You get closer and see that it is a proclamation, signed by Foltest, King of Temeria, Pontar and Mahakam... You might want to examine it further to read the details.

>see i
You can't see any such thing.

>see it
You read the proclamation carefully:

"BY ORDER OF KING FOLTEST OF TEMERIA

Let it be known to all citizens of Wyzim and its surroundings:

The palace district is hereby forbidden to all persons, by penalty of death. None shall enter, none shall linger after dark.

A creature of unknown nature dwells within the old palace vaults. It is dangerous. It kills. Fourteen years have passed since the curse was laid and seven since it first stirred.

His Majesty King Foltest, in his mercy, forbids any attempt upon the creature's life.

His Majesty hereby calls upon any man of skill and knowledge, witcher, sorcerer, or wise man, who believes themselves capable of lifting the curse upon the creature, to present themselves before the castellan Velerad at Wyzim.

Any man or woman capable of lifting the curse without harm to the creature shall be rewarded handsomely by the crown with three thousand oren.

Those who attempt to destroy the creature instead of breaking the spell will be tried for treason."

You think about pulling it off in case you need to ask about it.

>take it
You pull the leather off the wood, roll it up and tuck it into your jerkin. This certainly will be useful later.

* * *

>enter
You must supply a noun.

>enter fox inn
I only understood you as far as wanting to enter the Fox innkeeper.

* * *

>examine it
You get closer and see that it is a proclamation, signed by Foltest, King of Temeria, Pontar and Mahakam... You might want to examine it further to read the details.

>take it
You peel of the leather, and read carefully the proclamation:

BY ORDER OF KING FOLTEST OF TEMERIA

 Let it be known to all citizens of Wyzim and its surroundings:

 The palace district is hereby forbidden to all persons, by penalty of death. None shall enter, none shall linger after dark.

 A creature of unknown nature dwells within the old palace vaults. It is dangerous. It kills. Fourteen years have passed since the curse was laid and seven since it first stirred.

 His Majesty King Foltest, in his mercy, forbids any attempt upon the creature's life.

 His Majesty hereby calls upon any man of skill and knowledge, witcher, sorcerer, or wise man, who believes themselves capable of lifting the curse upon the creature, to present themselves before the castellan Velerad at Wyzim.

 Any man or woman capable of lifting the curse without harm to the creature shall be rewarded handsomely by the crown with three thousand oren. Those who attempt to destroy the creature instead of breaking the spell will be tried for treason.

 Enter the palace grounds at your own peril.

* * *

>examine leather
You get closer and see that it is a proclamation, signed by Foltest, King of Temeria, Pontar and Mahakam... You might want to examine it further to read the details.

>examine it
You read the proclamation carefully:

"BY ORDER OF KING FOLTEST OF TEMERIA

Let it be known to all citizens of Wyzim and its surroundings:

The palace district is hereby forbidden to all persons, by penalty of death. None shall enter, none shall linger after dark.

A creature of unknown nature dwells within the old palace vaults. It is dangerous. It kills. Fourteen years have passed since the curse was laid and seven since it first stirred.

His Majesty King Foltest, in his mercy, forbids any attempt upon the creature's life.

His Majesty hereby calls upon any man of skill and knowledge, witcher, sorcerer, or wise man, who believes themselves capable of lifting the curse upon the creature, to present themselves before the castellan Velerad at Wyzim.

Any man or woman capable of lifting the curse without harm to the creature shall be rewarded handsomely by the crown with three thousand oren.

Those who attempt to destroy the creature instead of breaking the spell will be tried for treason."

You think about peeling it off in case you need to ask about it.

>peel proclamation
I didn't understand that sentence.

* * *

>examine magical signs
The basic five witcher signs: Aard, Igni, Yrden, Quen, and Axii. You can examine further each sign.

>inventory
You are carrying:
  a Silver Sword
  an Iron Sword
  a Magical Signs Tome

>examine aard
The Aard sign is comprised of a telekinetic thrust that can stun, repel, knock down, or disarm opponents, as well as remove barriers and other objects.

>examine igni
The Igni sign is comprised of a pyrokinetic burst that can repel and ignite opponents, as well as start fires.

>examine Yrden
The Yrden sign when inscribed on a solid surface, it blocks the monsters from getting closer, scaring them off. If a hostile being enters the area affected by Sign, it is visibly slowed down, and non-corporeal forces become corporeal.

>examine Quen sign
The Quen sign when cast it forms a magical shield protecting you from sonic waves and similar attacks. Its expanded form can protect from the wider range of offensive actions. Contrary to Heliotrop, another sign which is active only for a moment and cushions from a single powerful attack, Quen is active until broken or dispelled.

>examine Axii
The Axii sign is comprised of a hypnotic effect. It can calm down people and creatures, manipulate their minds or be used to hex enemies, causing them to fight alongside the caster. The effect wears off over time or can be prematurely broken if they take damage from the caster.

* * *

>examine proclamation
You can't see any such thing.

>examine leather
You get closer, and you see that it is a proclamation. Signed by Foltest, King of Temeria, Pontar and Mahakam... You might want to examine it further to read the details.

>examine it
You read carefully the proclamation:

BY ORDER OF KING FOLTEST OF TEMERIA

Let it be known to all citizens of Wyzim and its surroundings:

The palace district is hereby forbidden to all persons, by penalty of death. None shall enter, none shall linger after dark.

A creature of unknown nature dwells within the old palace vaults. It is dangerous. It kills. Fourteen years have passed since the curse was laid and seven since it first stirred.

His Majesty King Foltest, in his mercy, forbids any attempt upon the creature's life.

His Majesty hereby calls upon any man of skill and knowledge, witcher, sorcerer, or wise man, who believes themselves capable of lifting the curse upon the creature, to present themselves before the castellan Velerad at Wyzim.

Any man or woman capable of lifting the curse without harm to the creature shall be rewarded handsomely by the crown with three thousand oren.

Those who attempt to destroy the creature instead of breaking the spell will be tried for treason.

You rolled the proclamation and tucked it into your jerkin.

>inventory
You are carrying nothing.

* * *

>examine leather
You get closer, and you see that it is a proclamation. Signed by Foltest, King of Temeria, Pontar and Mahakam... You might want to examine it further to read the details.

>examine wtf
You can't see any such thing.

* * *

>examine proclamation
You can't see any such thing.

>examine notice
You get closer, and you see that it is a proclamation. Signed by Foltest, King of Temeria, Pontar and Mahakam... You might want to examine it further to read the details.

>examine notice
You read carefully the proclamation:

BY ORDER OF KING FOLTEST OF TEMERIA

Let it be known to all citizens of Wyzim and its surroundings:

The palace district is hereby forbidden to all persons, by penalty of death. None shall enter, none shall linger after dark.

A creature of unknown nature dwells within the old palace vaults. It is dangerous. It kills. Fourteen years have passed since the curse was laid and seven since it first stirred.

His Majesty King Foltest, in his mercy, forbids any attempt upon the creature's life.

His Majesty hereby calls upon any man of skill and knowledge, witcher, sorcerer, or wise man, who believes themselves capable of lifting the curse upon the creature, to present themselves before the castellan Velerad at Wyzim.

Any man or woman capable of lifting the curse without harm to the creature shall be rewarded handsomely by the crown with three thousand oren.

Those who attempt to destroy the creature instead of breaking the spell will be tried for treason.

You rolled the proclamation and tucked it into your jerkin.

* * *

>examine self
You are Geralt of Rivia. Witcher. White hair, cat's eyes, two swords. You have been in worse places than this.

* * *

>examine temple
You can't see any such thing.

>go north
You can't go that way.

>kill
What do you want to kill?

>say hello, sailor
(to yourself)
There is no reply.

* * *

>examine yourslef
You can't see any such thing.

>examine yourself
You can't see any such thing.

>examine player
You can't see any such thing.

>examine me
You are Geralt of Rivia. Witcher. White hair, cat's eyes, two swords. You have been in worse places than this.

* * *

>get wad
You pull the leather off the wood, roll it up and tuck it into your jerkin. This certainly will be useful later.

* * *

>go east
You can't go that way.

>go south
You push open the door of The Fox. The hinges creak. Inside, it is dim and quiet. Just the way you like it.

Fox Inn
The Fox is quiet. A few candles burn low on the tables. The innkeeper glances up at you without alarm. He has seen worse, or at least pretends he has. This will do. The innkeeper eyes the hilt of your sword and then your face. He opens his mouth, thinks better of it, closes it again. He looks like a man with something heavy on his chest.

The innkeeper is a broad-shouldered man with a trimmed grey beard and careful eyes. He keeps his hands on the bar, easy and visible. You can ask for a room to stay the night.

>go east
Market Square
The market is winding down for the evening. Stall holders roll up their cloth and argue over the day's takings. At the far end, a barber is still open, with his red and white pole catching the last of the light. On the opposite side, a merchant with silver streaked hair sits at a tavern table with a cup that never seems to empty.

The Barber is a thin and a fidgety man with nimble fingers and has restless eyes. He has the barber's habit of talking to fill silence, or to play the role of an unsolicited therapist. You can try and ask him about the proclamation.

The merchant is a broad, well dressed man who seems entirely too comfortable for someone living in a city with a monster problem. He has the look of a man who has learned that gold can buy distance from most troubles. You can try and ask him about the proclamation.

On the wall at the northern end of the market, near the palace gate, someone has scratched a crude calendar into the stone. Fourteen years worth of marks, each month noted. And beside the seventh year, a different mark, a rough shape like a curled, sleeping figure, and beside it an arrow pointing east. Toward the palace.

* * *

>go east
Eastern Chamber
You cannot see. The room is cold. The floor under your boots has changed from bare stone to something that crunches faintly... old debris, small bones perhaps. The air in here is different from the corridor, enclosed... Something large at the centre of the room, something your outstretched hand finds at shoulder height. Stone, cold, rough-edged. A box. Very large and very old.She is in here. You can hear her. A low sound, not quite animal, closer to something in pain. Movement near the large stone object at the room's centre. She is not attacking. Not yet.

There is a heavy stone box, very large and very old...

Something inside the stone box breathes. You freeze. It has not heard you. Or it does not care...

>wait
Time passes.

You hear a sudden, sharp scrape of stone on stone. The breathing stops. Before you can move, a weight slams into the floor nearby, and a high, piercing shriek echoes off the chamber walls. You are no longer alone in the dark.

* * *

>go north
You can't go that way.

>fight
You must supply a noun.

>examine it
You see nothing unexpected in that direction.

>fight it
You must name something more substantial.

>fight the thing
You can't see any such thing.

* * *

>go norht
You can't see any such thing.

>go north
You push the door open and step inside.

Old Narakort Inn
You step inside. The smell of ale and sweat hits you first. The room is loud and packed. Farmers, merchants, a few armed men. The conversation dies the moment you cross the threshold. Every pair of eyes is on you. On your swords... On your eyes... Someone mutters something. Then another voice, louder: "We don't want your kind here, witcher."

You can drink, wait for something, even move, stay put or maybe ask them about the lether you found outside.. You think about leaving so you don't get into a fight for nothing.

A group of men sit hunched over their tankards, watching you with open hostility.

>ask them about it
One of them spits on the floor near your boot. They are not interested in conversation.

Before you can press further, you feel hands on your shoulders. A moment later you are back outside, blinking in the sunlight.

Crossroads
You stand in front of the Old Narakort Inn, facing north. You spend a few seconds looking at the entrance, listening to the hubbub of voices. The Inn is full of people who may get the wrong impression of you. Farther down the street there is a smaller inn named The Fox, facing south. It is quite empty. You think about a contract you could make and a place to sleep when the night falls. Maybe a quiet place is a good option.

You see a wad of white goat leather nailed to the wood near the entrance, with some runes written on it. You already saw the same leather across the road, on notice boards.

* * *

>go north
You push the door open and step inside.

Old Narakort Inn
You step inside. The smell of ale and sweat hits you first. The room is loud and packed. Farmers, merchants, a few armed men. The conversation dies the moment you cross the threshold. Every pair of eyes is on you. On your swords... On your eyes... Someone mutters something. Then another voice, louder: "We don't want your kind here, witcher."

You can drink, wait for something, even move, stay put or maybe ask them about the lether you found outside.. You think about leaving so you don't get into a fight for nothing.

A group of men sit hunched over their tankards, watching you with open hostility.

>ask about the wad
One of them spits on the floor near your boot. They are not interested in conversation.

Before you can press further, you feel hands on your shoulders. A moment later you are back outside, blinking in the sunlight.

Crossroads
You stand in front of the Old Narakort Inn, facing north. You spend a few seconds looking at the entrance, listening to the hubbub of voices. The Inn is full of people who may get the wrong impression of you. Farther down the street there is a smaller inn named The Fox, facing south. It is quite empty. You think about a contract you could make and a place to sleep when the night falls. Maybe a quiet place is a good option.

You see a wad of white goat leather nailed to the wood near the entrance, with some runes written on it. You already saw the same leather across the road, on notice boards.

* * *

>ask the men about the proclamation
One of them spits on the floor near your boot. They are not interested in conversation.

Before you can press further, you feel hands on your shoulders. A moment later you are back outside, blinking in the sunlight.

Crossroads
You stand in front of the Old Narakort Inn, facing north. You spend a few seconds looking at the entrance, listening to the hubbub of voices. The Inn is full of people who may get the wrong impression of you. Farther down the street there is a smaller inn named The Fox, facing south. It is quite empty. You think about a contract you could make and a place to sleep when the night falls. Maybe a quiet place is a good option.

You see a wad of white goat leather nailed to the wood near the entrance, with some runes written on it. You already saw the same leather across the road, on notice boards.

>go north
You push the door open and step inside.

Old Narakort Inn
You step inside. The smell of ale and sweat hits you first. The room is loud and packed. Farmers, merchants, a few armed men. The conversation dies the moment you cross the threshold. Every pair of eyes is on you. On your swords... On your eyes... Someone mutters something. Then another voice, louder: "We don't want your kind here, witcher."

You can drink, wait for something, even move, stay put or maybe ask them about the lether you found outside.. You think about leaving so you don't get into a fight for nothing.

A group of men sit hunched over their tankards, watching you with open hostility.

>ask men about something
The same man that spitted on the floor, gets up and yells. "You witchers are all the same... Fuck*** freaks". Before you can move the same man invites you to leave, with a knife in his hands. Then you feel two hands on your shoulders. A moment later you are back outside, blinking in the sunlight."

Crossroads
You stand in front of the Old Narakort Inn, facing north. You spend a few seconds looking at the entrance, listening to the hubbub of voices. The Inn is full of people who may get the wrong impression of you. Farther down the street there is a smaller inn named The Fox, facing south. It is quite empty. You think about a contract you could make and a place to sleep when the night falls. Maybe a quiet place is a good option.

You see a wad of white goat leather nailed to the wood near the entrance, with some runes written on it. You already saw the same leather across the road, on notice boards.

>go north
You push the door open and step inside.

Old Narakort Inn
You step inside. The smell of ale and sweat hits you first. The room is loud and packed. Farmers, merchants, a few armed men. The conversation dies the moment you cross the threshold. Every pair of eyes is on you. On your swords... On your eyes... Someone mutters something. Then another voice, louder: "We don't want your kind here, witcher."

You can drink, wait for something, even move, stay put or maybe ask them about the lether you found outside.. You think about leaving so you don't get into a fight for nothing.

A group of men sit hunched over their tankards, watching you with open hostility.

>ask men about something
This time, before you can draw your iron sword, several men wielding various knives rush toward you and stab you to death. Before you fall, you look down to see three iron spikes piercing through your belly, dripping blood onto the floor. You have been impaled by a three-headed pitchfork. As you bleed out on the wooden floor, you think about your own perceived stupidity. After all these years, you die by a pitchfork. Perhaps it was destiny, something one cannot control...

    *** You died... Try again and this time don't make stupid decisions! ***

Would you like to RESTART, RESTORE a saved game, QUIT or UNDO the last command?

* * *

>ask them about it
I'm not sure what 'them' refers to.

>ask crowd of men about it
One of them spits on the floor near your boot. They are not interested in conversation.

Before you can press further, you feel hands on your shoulders. A moment later you are back outside, blinking in the sunlight.

Crossroads
You stand in front of the Old Narakort Inn, facing north. You spend a few seconds looking at the entrance, listening to the hubbub of voices. The Inn is full of people who may get the wrong impression of you. Farther down the street there is a smaller inn named The Fox, facing south. It is quite empty. You think about a contract you could make and a place to sleep when the night falls. Maybe a quiet place is a good option.

You see a wad of white goat leather nailed to the wood near the entrance, with some runes written on it. You already saw the same leather across the road, on notice boards.

>go south
You push open the door of The Fox. The hinges creak. Inside, it is dim and quiet. Just the way you like it.

Fox Inn
The Fox is quiet. A few candles burn low on the tables. The innkeeper glances up at you without alarm. He has seen worse, or at least pretends he has. This will do. The innkeeper eyes the hilt of your sword and then your face. He opens his mouth, thinks better of it, closes it again. He looks like a man with something heavy on his chest.

The innkeeper is a broad-shouldered man with a trimmed grey beard and careful eyes. He keeps his hands on the bar, easy and visible. You can ask for a room to stay the night.

>ask him about it
The innkeeper studies you a moment, then sets down the rag he was using to wipe the bar. "You have a desire to die I guess... Going to a place like Narakort.". He pauses.
 "You're a witcher, aren't you?" He does not wait for an answer. "I can always tell. The eyes... You... That white hair. Also the medallion. A wolf... from Kaer Mor... Something like that. You know, one called Vesemir had hair almost like yours. Maybe I should not ask about it. A lot of witchers pass here and some talk and I listen." He pours a cup of something dark and slides it across the counter without being asked. "I'll not throw you out," he says. "A man's coin is a man's coin. But..." He hesitates. "Have you seen the proclamation?"

He glances toward the door before he speaks again.
The innkeeper lowers his voice. "The proclamation on the gate. I expect you read it." He glances around the empty room, habit more than caution. "Fourteen years ago a curse fell on the old palace. The creature that lives in the vaults... folks say it is a terrible monster. A cursed thing, half woman, half beast. Kills without reason. Velerad, the king's castellan, he is the one offering the contract. His office is in the castle keep, north through the market. This market is not far from my inn. You should get there easily by just going east from here."

He refills your cup."I'll give you a room, witcher. Cheapest in Wyzim. Consider it goodwill. We could use someone who isn't afraid of that thing." He slides a key across the worn wood of the bar. You scoop it up, feeling the cold iron against your palm, and secure it in your pocket.

>ask about it
Ask who?

>ask the fox about it
The innkeeper shrugs. "I've told you what I know. Velerad at the castle will know the rest. He's been living with this longer than any of us."

>go east
Market Square
The market is winding down for the evening. Stall holders roll up their cloth and argue over the day's takings. At the far end, a barber is still open, with his red and white pole catching the last of the light. On the opposite side, a merchant with silver streaked hair sits at a tavern table with a cup that never seems to empty.

The Barber is a thin and a fidgety man with nimble fingers and has restless eyes. He has the barber's habit of talking to fill silence, or to play the role of an unsolicited therapist. 

The merchant is a broad, well dressed man who seems entirely too comfortable for someone living in a city with a monster problem. He has the look of a man who has learned that gold can buy distance from most troubles. 

On the wall at the northern end of the market, near the palace gate, someone has scratched a crude calendar into the stone. Fourteen years worth of marks, each month noted. And beside the seventh year, a different mark, a rough shape like a curled, sleeping figure, and beside it an arrow pointing east. Toward the palace.

>ask him about it
The merchant looks you over with frank appraisal. "Silk," he says, offering his name like a coin. "I trade in fine goods. Or I did, before the palace business made this city a destination for the morbid and the desperate." He swirls his cup.

"You want to know about the monster. Everyone does." He leans back. "I was here when it first stirred. Seven years after the birth, as they say. I lost two good warehouse men that year. The thing comes out at night, crosses the district... But here is what I know that the others don't. It always returns before dawn. Always. Back to the crypt. Back to where it came from. I've watched."

He finishes his drink.

"I do not know why, but it returns every time, before the cock crows."

>ask the barber about it
The barber sets his razor down and leans forward. "You're here about the monster, aren't you? I can always tell. The eyes. And the swords, obviously." He lowers his voice to a theatrical whisper. "I'll tell you something no one else will. The creature... it was a child once. The king's daughter. Born of a cursed union, they say. The queen died in childbirth, and on that same night, the wise woman who came to deliver the girl laid a curse on her. Said she would not rest easy in death."

He picks up his razor again, examining the edge.

"Seven years she lay quiet in the crypt below the palace. Then she woke. Not herself. Not human." He draws a finger across his throat. "They sealed the palace after that. But she gets out sometimes. Into the district. People die."

>go north
Castle Keep
The castle is old and smells of damp stone and old candles. Guards eye you at the gate but let you pass. They know the look of someone who has come about the contract. Inside, the keep is dim, the tapestries faded. Velerad's office is at the end of the main corridor.

Velerad is a heavyset man in his fifties with a soldier's posture and a bureaucrat's tired eyes. He sits behind a broad desk covered in papers. You should talk with him!

A rolled map of the palace district lies on the corner of Velerad's desk.

A stiff parchment with Velerad's seal and the terms of the commission.

>ask about it
Ask who?

>ask Velerad about it
Velerad sets down his quill. "That medallion... A witcher. Good. Sit down." He does not wait to see if you will. "I am going to tell you everything, because the men I sent before you all died, and I am tired of burying good soldiers over a thing that might be fixed." He folds his hands.

"The creature is the king's daughter. Adda. Born under a curse laid by a wise woman at the birth. The circumstances I will not go into, they are... unpleasant, and irrelevant. For seven years she lay in the crypt below the palace, still. We thought the curse had come to nothing. Then she woke."

He stands and moves to a cabinet, pulling out a rolled map, which he sets flat on the desk. "The palace vaults below the old throne room. She lives there. The crypt has a sarcophagus, where she sleeps by day. At night she hunts. The king will not allow her to be killed, because she is his daughter. He believes the curse can be broken and I am... less certain. But those are my orders, and so I am offering three thousand oren to anyone who can lift it. A crazy old man once said that someone must spend the night with the thing until the cock crows for the third time. You should see what remains of him..." Velerad laughs. You know the old man was likely right. You've heard of this before. It is no wonder he died, however, as a striga is a formidable monster, even witchers struggle against one.

Velerad slides a document across the desk. It is a map. You should examine further.

"The crypt lies below the palace, through the old throne room, down one flight. The sarcophagus is in the eastern vault. You will need to go at night. The creature only emerges at night. Witcher, do you know how to break a striga's curse? Well good luck because I don't and don't care. To me this monster should be killed, and if it comes to that Witcher..." Velerad starts laughing. "If you must, kill it, but i can't help you if it comes to that.". 

You have many details on how the monster behaves, and maybe how to break the curse. "Just one more thing Witcher! Sign the contract before you leave and I will tell you something usefull! Or just leave if you don't like contracts..."

>go north
You can't go that way.

>go south
Market Square
The market is winding down for the evening. Stall holders roll up their cloth and argue over the day's takings. At the far end, a barber is still open, with his red and white pole catching the last of the light. On the opposite side, a merchant with silver streaked hair sits at a tavern table with a cup that never seems to empty.

The Barber is a thin and a fidgety man with nimble fingers and has restless eyes. He has the barber's habit of talking to fill silence, or to play the role of an unsolicited therapist. 

The merchant is a broad, well dressed man who seems entirely too comfortable for someone living in a city with a monster problem. He has the look of a man who has learned that gold can buy distance from most troubles. 

On the wall at the northern end of the market, near the palace gate, someone has scratched a crude calendar into the stone. Fourteen years worth of marks, each month noted. And beside the seventh year, a different mark, a rough shape like a curled, sleeping figure, and beside it an arrow pointing east. Toward the palace.

* * *

>take them
I'm not sure what 'them' refers to.

>take both
Black Blood Potion: You pocket the Black Blood potion carefully.
Cat Potion: You pocket the Cat potion. You will drink it before you go in.

>go north
Market Square
The market is winding down for the evening. Stall holders roll up their cloth and argue over the day's takings. At the far end, a barber is still open, with his red and white pole catching the last of the light. On the opposite side, a merchant with silver streaked hair sits at a tavern table with a cup that never seems to empty.

The Barber is a thin and a fidgety man with nimble fingers and has restless eyes. He has the barber's habit of talking to fill silence, or to play the role of an unsolicited therapist. 

The merchant is a broad, well dressed man who seems entirely too comfortable for someone living in a city with a monster problem. He has the look of a man who has learned that gold can buy distance from most troubles. 

On the wall at the northern end of the market, near the palace gate, someone has scratched a crude calendar into the stone. Fourteen years worth of marks, each month noted. And beside the seventh year, a different mark, a rough shape like a curled, sleeping figure, and beside it an arrow pointing east. Toward the palace.

* * *

>check main hall
You can't see any such thing.

>check fountain
The stains are old. Several years, at least. Whatever made them was dragged here from the direction of the main gate and left. An animal, perhaps.

>check upper windows
Something large broke out of the upper floor. Or tried to. Many of the frames are scored with deep scratch marks. You note them and move on.

>check upper Windows
Something large broke out of the upper floor. Or tried to. Many of the frames are scored with deep scratch marks. You note them and move on.

>go north
Old Palace Hall
The main hall is vast and hollow. Moonlight falls through the broken roof in pale columns, lighting nothing useful. Dust on the floor, disturbed in a path that leads from the far end of the hall, from the direction of the stairs going down, and across to the main doors. The path of something that moves on all fours, and then on two legs, and then on all fours again. The stairs to the vault are at the far end, going down. It is quiet. She is still below. You should prepare yourself...

There is a trail worn into the dust of the floor, leading from the vault stairs to the main doors.

>check trail
You crouch and study it. The prints shift between something like bare human feet and something not human at all, with long claw-raking marks. The creature walks upright sometimes. Not always. The trail is worn deep. She has made this journey many times.

You already knew what you were facing. But seeing the tracks makes it real in a different way. She was a child once. Whatever she is now, she was a child. You stand up and move toward the stairs.

>go down
Palace Vaults
The stairs end in darkness. Absolute darkness. You stop on the bottom step and hold still, letting your other senses work. The air is cold. Old. A smell like stone and something that has been alive a long time in a confined space. The floor is grit and old dust beneath your boots. You can hear the shape of the vault in the way sound does not travel. You cannot see. You move carefully.

Somewhere in your right, east, in the dark, something breathes very slowly.

* * *

>drink cat potion
You uncork the Cat potion and drink it in one swallow. Bitter as ash. For a moment the world dims, and then snaps back sharper than before. The dark is grey instead of black, shapes clear and distinct. You can see. Your cat eyes... are different.

Now you can see... The stairs end in grey half-light. The cat potion does its work. The vault is a long, low corridor with a stoned floor. Several chambers open off it. The eastern chamber lies at the far end. The air is cold and carries something that is not rot and not animal but is both and neither.

>go east
Eastern Chamber
A stone chamber. In the centre stands the sarcophagus, a heavy grey stone, its lid displaced, scored with deep claw marks along every edge. The smell is strong here. Old. Wrong.

 There is a heavy stone sarcophagus with its lid partially displaced. The stone around the edges is scored with claw marks, deep and repetitive, the work of years.

The sarcophagus. She is inside it. You can hear her breathing, slow and deep, through the gap in the lid.

You see the heavy lid of the sarcophagus begin to slide. A pale, clawed hand hooks over the edge, and with a sudden, violent burst of strength, she flings herself out. She crouches on the stone floor, her eyes reflecting the faint light, fixed entirely on you. You will need to fight it. Remember what you have! The black potion can weaken it, but you need let her attack you. But she is too close to you, you need to make her retreat. Use your silver sword or signs.

>check signs
The basic five witcher signs: Aard, Igni, Yrden, Quen, and Axii. You can examine further each sign.

>check aard
The Aard sign is comprised of a telekinetic thrust that can stun, repel, knock down, or disarm opponents, as well as remove barriers and other objects.

>check igni
The Igni sign is comprised of a pyrokinetic burst that can repel and ignite opponents, as well as start fires.

>check quen
The Quen sign when cast it forms a magical shield protecting you from sonic waves and similar attacks. Its expanded form can protect from the wider range of offensive actions. Contrary to Heliotrop, another sign which is active only for a moment and cushions from a single powerful attack, Quen is active until broken or dispelled.

>yrden
In a fight like this there is no room to inscribe the yrden sign on solid ground. SHe is too close to you. You need to drive her back first.

>aard
You cast Aard. The Striga is hurled several meters back, buying you a moment to think. You need to weaken her somehow.
Somehow you must survive until dawn with that beast. But how? Is there somewhere to hide? Somewhere you might use a sign to your advantage?
You still have the Black Blood Potion. You remember what the herbalist told you... Perhaps you should drink it and let her come to you.

>drink it
There's nothing suitable to drink here.

>drink black potion
You uncork it and swallow it in one go. No taste. Nothing. A moment later she is on you. Her jaws close on your forearm. Then she recoils, shrieking, shaking her head as if trying to rid herself of something she cannot name. The Black Blood did its work, and fast. She stumbles back, snarling and confused.

She is slowing down. This is your chance to finish her... But you will not receive the orens and you will be wanted by the crown of Foltest. You need to hide until dawn. Where can you go?

>hide in the box
In a flash, a thought cuts through the noise. The sarcophagus... it is open. You catch it from the corner of your eye. You run to it and climb in, pulling the lid over yourself. But it will not hold on its own. You need to keep her out somehow. Hold the lid? A sign, perhaps?

>hold
She throws her full weight against the lid and for a terrifying moment it moves, grinding open a full inch before you force it back. You wedge your boots against the far end of the sarcophagus and push with your legs instead of your arms.The gap narrows. She screams... a sound that fills the stone chamber and bounces off every wall. Her fingers pull back. Then, slower and more deliberate, she tries again. She is thinking. That is worse than the rage.

Somewhere above, distant and uncertain, a bird calls once and falls silent.

>hold it
That's fixed in place.

>hold
She gives one final push and something tears in your shoulder. The lid moves. It moves too far. The gap opens two inches, three, four  and her fingers are inside it, both hands now, pulling, and your legs are shaking and your shoulder is wrong in a way you cannot fix and the stone keeps grinding. The lid comes off.

She is above you before you can raise the sword. The last thing you see clearly is her face. The eyes, wrong, and beneath them the face of a girl, fourteen years old, who does not know what she is doing and cannot stop.

The sarcophagus fills with dark.

    *** You held the line until your body gave out. You should have sealed the lid. Learn about you Magical Signs... Examine them! ***

Would you like to RESTART, RESTORE a saved game, QUIT or UNDO the last command?

>Restart
They said the man came from the north, through Roper's Gate. He came on foot, leading his laden horse by the bridle. The street lay empty. The day was hot, yet the man wore a black coat thrown over his shoulders, as though the heat meant nothing to him. He drew attention to himself. With a heavy, unhurried stride, the stranger shifted the two swords strapped across his back. Though hidden beneath the coat, their shape remained unmistakable. He was not old, though his hair was white as a dead man's. White as bone.

A boy, peering between the slats of a fence, tugged at his mother's sleeve.

"Mama... that man carries two swords on his back. Like a bow."

His mother pulled him closer without looking.

"People say witchers always carry two swords," she murmured. "One for men. One for monsters." She paused. "They say some can't tell the difference anymore."

The Witcher
An Interactive Fiction by António Alves
Release 1 / Serial number 260323 / Inform 7 v10.1.2 / D

Crossroads
You stand in front of the Old Narakort Inn, facing north. You spend a few seconds looking at the entrance, listening to the hubbub of voices. The Inn is full of people who may get the wrong impression of you. Farther down the street there is a smaller inn named The Fox, facing south. It is quite empty. You think about a contract you could make and a place to sleep when the night falls. Maybe a quiet place is a good option.

You see a wad of white goat leather nailed to the wood near the entrance, with some runes written on it. You already saw the same leather across the road, on notice boards.

>see it
You get closer and see that it is a proclamation, signed by Foltest, King of Temeria, Pontar and Mahakam... You might want to examine it further to read the details.

* * *

>ask them about it
I'm not sure what 'them' refers to.

>ask them about the proclamation
I'm not sure what 'them' refers to.

>ask men about the proclamation
There is no reply.

* * *

>drink
Before you can settle in, two large men grab you by the arms and haul you toward the door. "Get out, freak," one of them growls. You do not resist. There is nothing here worth a fight.

You are back on the street.

Crossroads
You stand in front of the Old Narakort Inn, facing north. You spend a few seconds looking at the entrance, listening to the hubbub of voices. The Inn is full of people who may get the wrong impression of you. Farther down the street there is a smaller inn named The Fox, facing south. It is quite empty. You think about a contract you could make and a place to sleep when the night falls. Maybe a quiet place is a good option.

You see a wad of white goat leather nailed to the wood near the entrance, with some runes written on it. You already saw the same leather across the road, on notice boards.

>go north
You push the door open and step inside.

Old Narakort Inn
You step inside. The smell of ale and sweat hits you first. The room is loud and packed. Farmers, merchants, a few armed men. The conversation dies the moment you cross the threshold. Every pair of eyes is on you. On your swords... On your eyes... Someone mutters something. Then another voice, louder: "We don't want your kind here, witcher."

You can drink, wait for something, even move or stay put. You think about leaving so you don't get into a fight for nothing.

A group of men sit hunched over their tankards, watching you with open hostility.

>drink
Right as you move towards the bar, someone yells. "I think you are probably deaf. Get out freak!". This time, more than two men grab you by the arms and throw you out.

You are back on the street.

Crossroads
You stand in front of the Old Narakort Inn, facing north. You spend a few seconds looking at the entrance, listening to the hubbub of voices. The Inn is full of people who may get the wrong impression of you. Farther down the street there is a smaller inn named The Fox, facing south. It is quite empty. You think about a contract you could make and a place to sleep when the night falls. Maybe a quiet place is a good option.

You see a wad of white goat leather nailed to the wood near the entrance, with some runes written on it. You already saw the same leather across the road, on notice boards.

>go north
You push the door open and step inside.

Old Narakort Inn
You step inside. The smell of ale and sweat hits you first. The room is loud and packed. Farmers, merchants, a few armed men. The conversation dies the moment you cross the threshold. Every pair of eyes is on you. On your swords... On your eyes... Someone mutters something. Then another voice, louder: "We don't want your kind here, witcher."

You can drink, wait for something, even move or stay put. You think about leaving so you don't get into a fight for nothing.

A group of men sit hunched over their tankards, watching you with open hostility.

>drink
This time, before you can draw your iron sword, several men wielding various knives rush toward you and stab you to death. Before you fall, you look down to see three iron spikes piercing through your belly, dripping blood onto the floor. You have been impaled by a three-headed pitchfork. As you bleed out on the wooden floor, you think about your own perceived stupidity. After all these years, you die by a pitchfork. Perhaps it was destiny, something one cannot control...

    *** You died. Try again and this time don't make stupid decisions! ***

Would you like to RESTART, RESTORE a saved game, QUIT or UNDO the last command?

>RESTART
They said the man came from the north, through Roper's Gate. He came on foot, leading his laden horse by the bridle. The street lay empty. The day was hot, yet the man wore a black coat thrown over his shoulders, as though the heat meant nothing to him. He drew attention to himself. With a heavy, unhurried stride, the stranger shifted the two swords strapped across his back. Though hidden beneath the coat, their shape remained unmistakable. He was not old, though his hair was white as a dead man's. White as bone.

A boy, peering between the slats of a fence, tugged at his mother's sleeve.

"Mama... that man carries two swords on his back. Like a bow."

His mother pulled him closer without looking.

"People say witchers always carry two swords," she murmured. "One for men. One for monsters." She paused. "They say some can't tell the difference anymore."

The Witcher
An Interactive Fiction by António Alves
Release 1 / Serial number 260318 / Inform 7 v10.1.2 / D

Crossroads
You stand in front of the Old Narakort Inn, facing north. You spend a few seconds looking at the entrance, listening to the hubbub of voices. The Inn is full of people who may get the wrong impression of you. Farther down the street there is a smaller inn named The Fox, facing south. It is quite empty. You think about a contract you could make and a place to sleep when the night falls. Maybe a quiet place is a good option.

You see a wad of white goat leather nailed to the wood near the entrance, with some runes written on it. You already saw the same leather across the road, on notice boards.

* * *

>go sout
You can't see any such thing.

>go south
You push open the door of The Fox. The hinges creak. Inside, it is dim and quiet. Just the way you like it.

Fox Inn
The Fox is quiet. A few candles burn low on the tables. The innkeeper glances up at you without alarm. He has seen worse, or at least pretends he has. This will do. The innkeeper eyes the hilt of your sword and then your face. He opens his mouth, thinks better of it, closes it again. He looks like a man with something heavy on his chest.

The innkeeper is a broad-shouldered man with a trimmed grey beard and careful eyes. He keeps his hands on the bar, easy and visible. You can ask for a room to stay the night.

>ask the innkeeper about the proclamation
The innkeeper studies you a moment, then sets down the rag he was using to wipe the bar. "You have a desire to die I guess... Going to a place like Narakort.". He pauses.
 "You're a witcher, aren't you?" He does not wait for an answer. "I can always tell. The eyes... You... That white hair. Also the medallion. A wolf... from Kaer Mor... Something like that. You know, one called Vesemir had hair almost like yours. Maybe I should not ask about it. A lot of witchers pass here and some talk and I listen." He pours a cup of something dark and slides it across the counter without being asked. "I'll not throw you out," he says. "A man's coin is a man's coin. But..." He hesitates. "Have you seen the proclamation?"

He glances toward the door before he speaks again. You think on asking about the proclamation...
The innkeeper lowers his voice. "The proclamation on the gate. I expect you read it." He glances around the empty room, habit more than caution. "Fourteen years ago a curse fell on the old palace. The creature that lives in the vaults... folks say it is a terrible monster. A cursed thing, half woman, half beast. Kills without reason. Velerad, the king's castellan, he is the one offering the contract. His office is in the castle keep, north through the market. This market is not far from my inn. You should get there easily by just going east from here."

He refills your cup."I'll give you a room, witcher. Cheapest in Wyzim. Consider it goodwill. We could use someone who isn't afraid of that thing." He slides a key across the worn wood of the bar. You scoop it up, feeling the cold iron against your palm, and secure it in your pocket.

>go eas
You can't see any such thing.

>go easr
You can't see any such thing.

>go east
Market Square
The market is winding down for the evening. Stall-holders roll up their cloth and argue over the day's takings. At the far end, a barber is still open, his red-and-white pole catching the last of the light. On the opposite side, a merchant with silver-streaked hair sits at a tavern table with a cup that never seems to empty.

The Barber is thin and a fidgety man with nimble fingers and restless eyes. He has the barber's habit of talking to fill silence, or to play the role of an unsolicited therapist. You can try and ask him about the proclamation.

The merchant is a broad, well-dressed man who seems entirely too comfortable for someone living in a city with a monster problem. He has the look of a man who has learned that gold can buy distance from most troubles. You can try and aks him about the proclamation.

On the wall at the northern end of the market, near the palace gate, someone has scratched a crude calendar into the stone. Fourteen years worth of marks, each month noted. And beside the seventh year, a different mark, a rough shape like a curled, sleeping figure, and beside it an arrow pointing east. Toward the palace.

>see barber
He sharpens a razor on a leather strap, though he keeps glancing toward the north, toward the palace district.

* * *

>examine it
You see nothing unexpected in that direction.

* * *

>leave
But you aren't in anything at the moment.

* * *

>leave it
I only understood you as far as wanting to leave.

>back
That's not a verb I recognise.

>go south
Crossroads
You stand in front of the Old Narakort Inn, facing north. You spend a few seconds looking at the entrance, listening to the hubbub of voices. The Inn is full of people who may get the wrong impression of you. Farther down the street there is a smaller inn named The Fox, facing south. It is quite empty.

You see a wad of white goat leather nailed to the wood near the entrance, with some runes written on it. You already saw the same leather across the road.

>go north
You push the door open and step inside.

Old Narakort Inn
You step inside. The smell of ale and sweat hits you first. The room is loud and packed. Farmers, merchants, a few armed men. The conversation dies the moment you cross the threshold. Every pair of eyes is on you. On your swords... On your eyes... Someone mutters something. Then another voice, louder: "We don't want your kind here, witcher."

A group of men sit hunched over their tankards, watching you with open hostility.

* * *

>talk with them
One of them spits on the floor near your boot. They are not interested in conversation.

Before you can press further, you feel hands on your shoulders. A moment later you are back outside, blinking in the sunlight.

Crossroads
You stand in front of the Old Narakort Inn, facing north. You spend a few seconds looking at the entrance, listening to the hubbub of voices. The Inn is full of people who may get the wrong impression of you. Farther down the street there is a smaller inn named The Fox, facing south. It is quite empty. You think about a contract you could make and a place to sleep when the night falls. Maybe a quiet place is a good option.

You see a wad of white goat leather nailed to the wood near the entrance, with some runes written on it. You already saw the same leather across the road, on notice boards.

>talk to them
You can't see 'them' (nothing) at the moment.

* * *

>go outh
You can't see any such thing.

>go south
You push open the door of The Fox. The hinges creak. Inside, it is dim and quiet. Just the way you like it.

Fox Inn
The Fox is quiet. A few candles burn low on the tables. The innkeeper glances up at you without alarm. He has seen worse, or at least pretends he has. This will do. The innkeeper eyes the hilt of your sword and then your face. He opens his mouth, thinks better of it, closes it again. He looks like a man with something heavy on his chest.

The innkeeper is a broad-shouldered man with a trimmed grey beard and careful eyes. He keeps his hands on the bar, easy and visible. You can ask for a room to stay the night.

>go east
Market Square
The market is winding down for the evening. Stall holders roll up their cloth and argue over the day's takings. At the far end, a barber is still open, with his red and white pole catching the last of the light. On the opposite side, a merchant with silver streaked hair sits at a tavern table with a cup that never seems to empty.

The Barber is a thin and a fidgety man with nimble fingers and has restless eyes. He has the barber's habit of talking to fill silence, or to play the role of an unsolicited therapist. 

The merchant is a broad, well dressed man who seems entirely too comfortable for someone living in a city with a monster problem. He has the look of a man who has learned that gold can buy distance from most troubles. 

On the wall at the northern end of the market, near the palace gate, someone has scratched a crude calendar into the stone. Fourteen years worth of marks, each month noted. And beside the seventh year, a different mark, a rough shape like a curled, sleeping figure, and beside it an arrow pointing east. Toward the palace.

>go east
The palace gate stands closed. The guards notices you. "Hey you!" but you notice also that they are nervous or almost terrified. For sure they don't want to be there. They notice the two swords and say, "Oh... haha, well you are witcher aint you? We can let you pass but we will not check on you!" You go through without a word.

Inside the courtyard, the silence hits you first. No insects. No birds. Nothing wants to be near this place after dark. Maybe you should prepare before going further... Check your swords and signs.

Ruined Courtyard
The palace courtyard is a ruin. Weeds push through the paving. A fountain has long since gone dry, its basin full of dead leaves. The main doors of the palace hang open and they have not been properly closed in years. The windows above are dark. Something has broken most of them from the inside. It is very quiet. The main hall waits ahead.

There is a stone fountain, ornate once, now cracked and dry. The basin is filled with old leaves and what might be old bloodstains, gone brown.

The upper windows of the palace are all broken, most from the inside, and shards of old glass lie on the ledges and the courtyard below.

>go north
Old Palace Hall
The main hall is vast and hollow. Moonlight falls through the broken roof in pale columns, lighting nothing useful. Dust on the floor, disturbed in a path that leads from the far end of the hall, from the direction of the stairs going down, and across to the main doors. The path of something that moves on all fours, and then on two legs, and then on all fours again. The stairs to the vault are at the far end, going down. It is quiet. She is still below.

There is a trail worn into the dust of the floor, leading from the vault stairs to the main doors.

* * *

>go down
Palace Vaults
The stairs end in darkness. Absolute darkness. You stop on the bottom step and hold still, letting your other senses work. The air is cold. Old. A smell like stone and something that has been alive a long time in a confined space. The floor is grit and old dust beneath your boots. You can hear the shape of the vault in the way sound does not travel. You cannot see. You move carefully.

Somewhere in your right, east, in the dark, something breathes very slowly.

>go east
Eastern Chamber
You cannot see. The room is cold. The floor under your boots has changed from bare stone to something that crunches faintly... old debris, small bones perhaps. The air in here is different from the corridor, enclosed... Something large at the centre of the room, something your outstretched hand finds at shoulder height. Stone, cold, rough-edged. A box. Very large and very old.She is in here. You can hear her. A low sound, not quite animal, closer to something in pain. Movement near the large stone object at the room's centre. She is not attacking. Not yet.

There is a heavy stone box, very large and very old...

Something inside the stone box breathes. You freeze. It has not heard you. Or it does not care...

>wait
Time passes.

You hear a sudden, sharp scrape of stone on stone. The breathing stops. Before you can move, a weight slams into the floor nearby, and a high, piercing shriek echoes off the chamber walls. You are no longer alone in the dark. The thing is no longer inside the box. You can attack the thing or try to run or pray...

>attack the thing
You swing blindly into the darkness, but you hit nothing but cold air. The sound of your own blade whistling reveals your position.
A screech echoes from your left, and then silence. Then, the claws find you.

    *** You cannot fight what you cannot see. You should have prepared more... Witchers are always cautious and keep a Cat Potion with them at all times. You should explore further to find a herbalist. ***

Would you like to RESTART, RESTORE a saved game, QUIT or UNDO the last command?

* * *

>go south
You push open the door of The Fox. The hinges creak. Inside, it is dim and quiet. Just the way you like it.

Fox Inn
The Fox is quiet. A few candles burn low on the tables. The innkeeper glances up at you without alarm. He has seen worse, or at least pretends he has. This will do. The innkeeper eyes the hilt of your sword and then your face. He opens his mouth, thinks better of it, closes it again. He looks like a man with something heavy on his chest.

The innkeeper is a broad-shouldered man with a trimmed grey beard and careful eyes. He keeps his hands on the bar, easy and visible. You can ask for a room to stay the night.

>ask about it
Ask who?

>ask him about it
The innkeeper studies you a moment, then sets down the rag he was using to wipe the bar.  "You're a witcher, aren't you?" He does not wait for an answer. "I can always tell. The eyes... You... That white hair. Also the medallion. A wolf... from Kaer Mor... Something like that. You know, one called Vesemir had hair almost like yours. Maybe I should not ask about it. A lot of witchers pass here and some talk and I listen." He pours a cup of something dark and slides it across the counter without being asked. "I'll not throw you out," he says. "A man's coin is a man's coin. But..." He hesitates. "Have you seen the proclamation?"

He glances toward the door before he speaks again.
The innkeeper lowers his voice. "The proclamation on the gate. I expect you read it." He glances around the empty room, habit more than caution. "Fourteen years ago a curse fell on the old palace. The creature that lives in the vaults... folks say it is a terrible monster. A cursed thing, half woman, half beast. Kills without reason. Velerad, the king's castellan, he is the one offering the contract. His office is in the castle keep, north through the market. This market is not far from my inn. You should get there easily by just going east from here."

He refills your cup."I'll give you a room, witcher. Cheapest in Wyzim. Consider it goodwill. We could use someone who isn't afraid of that thing." He slides a key across the worn wood of the bar. You scoop it up, feeling the cold iron against your palm, and secure it in your pocket.

* * *

>ask for a room
You can't see any such thing.

>ask the innkeeper for a room
You can't see any such thing.

>ask the fox innkeeper for a room
You can't see any such thing.

>ask the innkeeper about a room
The innkeeper studies you a moment, then sets down the rag he was using to wipe the bar. "You're a witcher, aren't you?" He does not wait for an answer. "I can always tell. The eyes... You... That white hair. Also the medallion. A wolf... from Kaer Mor... Something like that. You know, one called Vesemir had hair almost like yours. Maybe I should not ask about it. A lot of witchers pass here and some talk and I listen." He pours a cup of something dark and slides it across the counter without being asked. "I'll not throw you out," he says. "A man's coin is a man's coin. But..." He hesitates. "Have you seen the proclamation?"

He glances toward the door before he speaks again. You think on asking about the proclamation...
The innkeeper lowers his voice. "The proclamation on the gate. I expect you read it." He glances around the empty room, habit more than caution. "Fourteen years ago a curse fell on the old palace. The creature that lives in the vaults... folks say it is a terrible monster. A cursed thing, half woman, half beast. Kills without reason. Velerad, the king's castellan, he is the one offering the contract. His office is in the castle keep, north through the market. This market is not far from my inn. You should get there easily by just going east from here."

He refills your cup."I'll give you a room, witcher. Cheapest in Wyzim. Consider it goodwill. We could use someone who isn't afraid of that thing." He slides a key across the worn wood of the bar. You scoop it up, feeling the cold iron against your palm, and secure it in your pocket.

>ask the inkeeper
You can't see any such thing.

>ask the inkeeper about something
You can't see any such thing.

>ask the inkeeper about the proclamation
You can't see any such thing.

>ask the innkeeper about the proclamation
The innkeeper shrugs. "I've told you what I know. Velerad at the castle will know the rest. He's been living with this longer than any of us."

>ask the innkeeper about something
The innkeeper shrugs. "I've told you what I know. Velerad at the castle will know the rest. He's been living with this longer than any of us."

>take it
You must name something more substantial.

>take key
You already have that.

>examine key
A heavy iron key. The innkeeper gave it to you as goodwill, though you suspect he just wants the monster gone.

>talk to innkeeper
The innkeeper shrugs. "I've told you what I know. Velerad at the castle will know the rest. He's been living with this longer than any of us."

>rest
You could sleep. But the proclamation sits in your jerkin like a stone. First, the castle. First, Velerad. You need that oren to eat and continue your journey. It is not that late so you can do a contract first before sleeping.

>go east
Market Square
The market is winding down for the evening. Stall-holders roll up their cloth and argue over the day's takings. At the far end, a barber is still open, his red-and-white pole catching the last of the light. On the opposite side, a merchant with silver-streaked hair sits at a tavern table with a cup that never seems to empty.

A thin, fidgety man with nimble fingers and restless eyes. He has the barber's habit of talking to fill silence, or to play the role of an unsolicited therapist.

A broad, well-dressed man who seems entirely too comfortable for someone living in a city with a monster problem. He has the look of a man who has learned that gold can buy distance from most troubles.

On the wall at the northern end of the market, near the palace gate, someone has scratched a crude calendar into the stone. Fourteen years worth of marks, each month noted. And beside the seventh year, a different mark, a rough shape like a curled, sleeping figure, and beside it an arrow pointing east. Toward the palace.

>examine barber
He sharpens a razor on a leather strap, though he keeps glancing toward the north, toward the palace district.

>examine the barber
He sharpens a razor on a leather strap, though he keeps glancing toward the north, toward the palace district.

>examine the merchant
He wears good cloth and a careful smile. His eyes, though, move constantly. The kind of man who always knows where the nearest exit is.

>examine the wall
Someone kept a record. The marks for the first seven years are faint. The marks after are deep, frantic, the scratching of a person who needed to remember. The curled figure and the eastern arrow are the last entry. No more marks after that.

You trace the marks with a finger. Seven years of nothing. Then the creature woke. The shape beside the seventh year mark, curled, like something sleeping. It rested in the crypt for seven years before it stirred. And the arrow east. Toward the palace. Toward the vaults below it.

You already know where you must go.

>go east
You can't go that way.

>go oeast
You can't see any such thing.

>go west
You push open the door of The Fox. The hinges creak. Inside, it is dim and quiet. Just the way you like it.

Fox Inn
The Fox is quiet. A few candles burn low on the tables. The innkeeper glances up at you without alarm. He has seen worse, or at least pretends he has. This will do. The innkeeper mentioned the castle. You should ask him more about it, or head there yourself. It lies north of this inn. Speak with Velerad. You could also try the market and ask around.

The innkeeper is a broad-shouldered man with a trimmed grey beard and careful eyes. He keeps his hands on the bar, easy and visible. You can ask for a room to stay the night.

>go east
Market Square
The market is winding down for the evening. Stall-holders roll up their cloth and argue over the day's takings. At the far end, a barber is still open, his red-and-white pole catching the last of the light. On the opposite side, a merchant with silver-streaked hair sits at a tavern table with a cup that never seems to empty.

A thin, fidgety man with nimble fingers and restless eyes. He has the barber's habit of talking to fill silence, or to play the role of an unsolicited therapist.

A broad, well-dressed man who seems entirely too comfortable for someone living in a city with a monster problem. He has the look of a man who has learned that gold can buy distance from most troubles.

On the wall at the northern end of the market, near the palace gate, someone has scratched a crude calendar into the stone. Fourteen years worth of marks, each month noted. And beside the seventh year, a different mark, a rough shape like a curled, sleeping figure, and beside it an arrow pointing east. Toward the palace.

>go east
You can't go that way.

* * *

>ask him about it
The innkeeper studies you a moment, then sets down the rag he was using to wipe the bar.  "You're a witcher, aren't you?" He does not wait for an answer. "I can always tell. The eyes... You... That white hair. Also the medallion. A wolf... from Kaer Mor... Something like that. You know, one called Vesemir had hair almost like yours. Maybe I should not ask about it. A lot of witchers pass here and some talk and I listen." He pours a cup of something dark and slides it across the counter without being asked. "I'll not throw you out," he says. "A man's coin is a man's coin. But..." He hesitates. "Have you seen the proclamation?"

He glances toward the door before he speaks again.
The innkeeper lowers his voice. "The proclamation on the gate. I expect you read it." He glances around the empty room, habit more than caution. "Fourteen years ago a curse fell on the old palace. The creature that lives in the vaults... folks say it is a terrible monster. A cursed thing, half woman, half beast. Kills without reason. Velerad, the king's castellan, he is the one offering the contract. His office is in the castle keep, north through the market. This market is not far from my inn. You should get there easily by just going east from here."

He refills your cup."I'll give you a room, witcher. Cheapest in Wyzim. Consider it goodwill. We could use someone who isn't afraid of that thing." He slides a key across the worn wood of the bar. You scoop it up, feeling the cold iron against your palm, and secure it in your pocket.

>ask the fox innkeeper about it
The innkeeper shrugs. "I've told you what I know. Velerad at the castle will know the rest. He's been living with this longer than any of us."

* * *

>go north
Old Palace Hall
The main hall is vast and hollow. Moonlight falls through the broken roof in pale columns, lighting nothing useful. Dust on the floor, disturbed in a path that leads from the far end of the hall, from the direction of the stairs going down, and across to the main doors. The path of something that moves on all fours, and then on two legs, and then on all fours again. The stairs to the vault are at the far end, going down. It is quiet. She is still below. You should prepare yourself...

There is a trail worn into the dust of the floor, leading from the vault stairs to the main doors.

>go down
Palace Vaults
The stairs end in darkness. Absolute darkness. You stop on the bottom step and hold still, letting your other senses work. The air is cold. Old. A smell like stone and something that has been alive a long time in a confined space. The floor is grit and old dust beneath your boots. You can hear the shape of the vault in the way sound does not travel. You cannot see. You move carefully.

Somewhere in your right, east, in the dark, something breathes very slowly.

>go east
Eastern Chamber
You cannot see. The room is cold. The floor under your boots has changed from bare stone to something that crunches faintly... old debris, small bones perhaps. The air in here is different from the corridor, enclosed... Something large at the centre of the room, something your outstretched hand finds at shoulder height. Stone, cold, rough-edged. A box. Very large and very old.

There is a heavy stone box, very large and very old...

Something inside the stone box breathes. You freeze. It has not heard you. Or it does not care...

>check it
You hear a sudden, sharp scrape of stone on stone. The breathing stops. Before you can move, a weight slams into the floor nearby, and a high, piercing shriek echoes off the chamber walls. You are no longer alone in the dark.

>attack it
Before you can draw your silver sword, you are immediately pushed against wall. You can smell it... Then you can't breath. Your throat is destroyed...

    *** You should have prepared more... Witchers are always cautious and keep a Cat Potion with them at all times. You should explore further to find a herbalist. ***

Would you like to RESTART, RESTORE a saved game, QUIT or UNDO the last command?

* * *

>go east
Eastern Chamber
You cannot see. The room is cold. The floor under your boots has changed from bare stone to something that crunches faintly... old debris, small bones perhaps. The air in here is different from the corridor, enclosed... Something large at the centre of the room, something your outstretched hand finds at shoulder height. Stone, cold, rough-edged. A box. Very large and very old.

There is a heavy stone box, very large and very old...

Something inside the stone box breathes. You freeze. It has not heard you. Or it does not care...

>examine it
You hear a sudden, sharp scrape of stone on stone. The breathing stops. Before you can move, a weight slams into the floor nearby, and a high, piercing shriek echoes off the chamber walls. You are no longer alone in the dark. The thing is no longer inside the box. You can attack the thing or try to run or pray...

>attack
What do you want to attack?

>attack it
Before you can draw your silver sword, you are immediately pushed against wall. You can smell it... Then you can't breath. Your throat is destroyed...

    *** You should have prepared more... Witchers are always cautious and keep a Cat Potion with them at all times. You should explore further to find a herbalist. ***

Would you like to RESTART, RESTORE a saved game, QUIT or UNDO the last command?

* * *

>examine it
You hear a sudden, sharp scrape of stone on stone. The breathing stops. Before you can move, a weight slams into the floor nearby, and a high, piercing shriek echoes off the chamber walls. You are no longer alone in the dark. The thing is no longer inside the box. You can attack the thing or try to run or pray...

>examine box
You try to react, swinging your arms in the pitch black, but you are far too slow for a creature of the night. You feel a heavy weight slam into your chest, pinning you against the cold stone wall. A wet, hot breath hits your neck, and then searing pain. Your throat is torn open before you can even scream.

    *** Witchers who cannot see their prey do not live long. You should have drunk a Cat Potion. Find a herbalist! ***

Would you like to RESTART, RESTORE a saved game, QUIT or UNDO the last command?

>examine it
Please give one of the answers above.

Would you like to RESTART, RESTORE a saved game, QUIT or UNDO the last command?

>examine the box
Please give one of the answers above.

Would you like to RESTART, RESTORE a saved game, QUIT or UNDO the last command?

>wait
Please give one of the answers above.

Would you like to RESTART, RESTORE a saved game, QUIT or UNDO the last command?

* * *

>examine it
You hear a sudden, sharp scrape of stone on stone. The breathing stops. Before you can move, a weight slams into the floor nearby, and a high, piercing shriek echoes off the chamber walls. You are no longer alone in the dark. The thing is no longer inside the box. You can attack the thing or try to run or pray...

>hide in the bo
You can't see any such thing.

>hide in the box
For some reason, you think about entering the box... With a quick step, you go inside and start moving the lid to close yourself in. But you still need to, somehow, guarantee that she does not open it, maybe by holding the lid?

>hold lid
She throws her full weight against the lid and for a terrifying moment it moves, grinding open a full inch before you force it back. You wedge your boots against the far end of the sarcophagus and push with your legs instead of your arms.The gap narrows. She screams... a sound that fills the stone chamber and bounces off every wall. Her fingers pull back. Then, slower and more deliberate, she tries again. She is thinking. That is worse than the rage.

Somewhere above, distant and uncertain, a bird calls once and falls silent.

>cast yrden
You lay your sword on your chest and raise one hand to the stone slab above you. In the dark of the sarcophagus you trace the Yrden sign on the inside of the lid. The lines settle into something you feel more than see... a faint warmth against cold stone, a stillness that seeps down through the slab. You should wait or brace yourself.

>wait
She gives one final push, but this time something is wrong. The force behind it is less than it should be. Through the stone, you can feel it... she is slowing. The Yrden sign has done its work, sapping the violence from her and turning her strength into confusion. She presses against the lid once, twice, weakly, like a creature that has forgotten why it is fighting. Then, she stops. The pressure vanishes. You fall into a deep state of mind, almost meditating... You could get out now to see if the curse is lifted, or you could stay inside.

The cock crows for the second time...

>wait
You push the lid aside yourself and sit up. Dawn light fills the chamber... pale and clean, falling through a crack in the vault ceiling. It touches the floor. It touches her. She is on the floor beside the sarcophagus. A girl with fourteen years old, skin and bone, curled on the cold stone as though she had simply lain down to sleep. She is shaking.

Her eyes open. They are human eyes. She stares up at you, sitting upright in a sarcophagus with the sword still across your chest. Her mouth moves. No words come. She has not spoken in seven years. But the eyes are hers. Whatever lived behind them before is gone. You climb out and set her down more gently than your aching arms would prefer.

The curse is broken. You should carry the girl to the Palace Vaults.

>carry the girl to the Palace Vaults
You carry the girl up to the main hall, then out through the palace doors into the courtyard. The morning air is cool and clean after the vaults. Velerad is already waiting at the gate. He did not sleep. He sees you, sees the girl, and his face does something complicated... relief and grief and something else.

"Is she..." he starts. "Alive," you say. "The curse is broken.". Velerad takes the girl from your arms carefully, as though she might shatter. She does not wake. She breathes. "The king will want to see her." His voice is rough. You accept the purse of coin he hands you. The contract is fulfilled.

"Witcher," Velerad says, as you turn to go. "Will she be... herself again?" You look at the girl in his arms. Fourteen years in a crypt. Seven of them not quite human. What comes back from that, you do not know. You have done what you were paid to do."She will be alive," you say. "That is the start."

You walk back through the market as the city wakes around you. Someone with sharp eyes recognizes what you are. No one says anything. Three thousand oren in your pocket. Your horse waiting at The Fox. Time to move on.

    *** The curse is lifted. Adda lives. You ride north. To your destiny. To the Law of Surprise... The Elder Blood... You blink and think on this thoughts. Maybe there will be a chance where you will invoke the famous Law of Surprise, just like some witchers did in the past! Your destiny is forth! ***

Would you like to RESTART, RESTORE a saved game, QUIT or UNDO the last command?

>carry the girl
Please give one of the answers above.

Would you like to RESTART, RESTORE a saved game, QUIT or UNDO the last command?

* * *

>examine it
You hear a sudden, sharp scrape of stone on stone. The breathing stops. Before you can move, a weight slams into the floor nearby, and a high, piercing shriek echoes off the chamber walls. You are no longer alone in the dark. The thing is no longer inside the box. You can attack the thing or try to run or pray...

>run
You'll have to say which compass direction to go in.

>run out
You try to react, swinging your arms in the pitch black, but you are far too slow for a creature of the night. You feel a heavy weight slam into your chest, pinning you against the cold stone wall. A wet, hot breath hits your neck, and then searing pain. Your throat is torn open before you can even scream.

    *** Witchers who cannot see their prey do not live long. You should have drunk a Cat Potion. Find a herbalist! ***

Would you like to RESTART, RESTORE a saved game, QUIT or UNDO the last command?

* * *

>go east
Eastern Chamber
You cannot see. The room is cold. The floor under your boots has changed from bare stone to something that crunches faintly... old debris, small bones perhaps. The air in here is different from the corridor, enclosed... Something large at the centre of the room, something your outstretched hand finds at shoulder height. Stone, cold, rough-edged. A box. Very large and very old.

There is a heavy stone box, very large and very old...

Something inside the stone box breathes. You freeze. It has not heard you. Or it does not care...

>go west
Palace Vaults
The stairs end in darkness. Absolute darkness. You stop on the bottom step and hold still, letting your other senses work. The air is cold. Old. A smell like stone and something that has been alive a long time in a confined space. The floor is grit and old dust beneath your boots. You can hear the shape of the vault in the way sound does not travel. You cannot see. You move carefully.

You hear her. Close. A sound between breathing and growling, just ahead in the dark. You cannot tell exactly where.

Something moves in the dark ahead of you. The slow breathing stops. Stone grinds on stone. Then there is a sound you have no name for, and the air moves, and something is in the corridor with you.

>go east
You try to identify where the sound is coming from. You move very slowly, but before you have time to react, you see claws driving straight into your face. You fall to the ground, seeing only pitch black. You cannot breathe; your throat has been slashed by the monster's nails.

    *** You should have prepared more... Witchers are always cautious and keep a Cat Potion with them at all times. You should explore further to find a herbalist. ***

Would you like to RESTART, RESTORE a saved game, QUIT or UNDO the last command?

* * *

>go east
Eastern Chamber
You cannot see. The room is cold. The floor under your boots has changed from bare stone to something that crunches faintly... old debris, small bones perhaps. The air in here is different from the corridor, enclosed... Something large at the centre of the room, something your outstretched hand finds at shoulder height. Stone, cold, rough-edged. A box. Very large and very old.

There is a heavy stone box, very large and very old...

Something inside the stone box breathes. You freeze. It has not heard you. Or it does not care...

>see the box
 

You reach into the stone box. Your fingers find cloth, then skin, then she is moving and you stumble back into the wall. The lid hits the floor. She hits you a heartbeat later, her weight nothing but her speed everything, and you go down hard and roll and she is off you before you can grip anything. She screams. It fills the chamber and keeps going after it should have stopped. She is between you and the door. You cannot see her. You can hear her. You can try to fight something you cannot see and fast, or that box...

>fight it
Before you can draw your silver sword, you are immediately pushed against wall. You can smell it... Then you can't breath. Your throat is destroyed...

    *** You should have prepared more... Witchers are always cautious and keep a Cat Potion with them at all times. You should explore further to find a herbalist. ***

Would you like to RESTART, RESTORE a saved game, QUIT or UNDO the last command?

>fight it
Please give one of the answers above.

Would you like to RESTART, RESTORE a saved game, QUIT or UNDO the last command?

>fight
Please give one of the answers above.

Would you like to RESTART, RESTORE a saved game, QUIT or UNDO the last command?

* * *

>go east
Eastern Chamber
You cannot see. The room is cold. The floor under your boots has changed from bare stone to something that crunches faintly... old debris, small bones perhaps. The air in here is different from the corridor, enclosed... Something large at the centre of the room, something your outstretched hand finds at shoulder height. Stone, cold, rough-edged. A box. Very large and very old.

There is a heavy stone box, very large and very old...

Something inside the stone box breathes. You freeze. It has not heard you. Or it does not care...

>wait
Time passes.

You hear a sudden, sharp scrape of stone on stone. The breathing stops. Before you can move, a weight slams into the floor nearby, and a high, piercing shriek echoes off the chamber walls. You are no longer alone in the dark. The thing is no longer inside the box. You can attack the thing or try to run or pray...

>go inside the box
For some reason, you think about entering the box... With a quick step, you go inside and start moving the lid to close yourself in. But you still need to, somehow, guarantee that she does not open it.

>wait
She throws her full weight against the lid and for a terrifying moment it moves, grinding open a full inch before you force it back. You wedge your boots against the far end of the sarcophagus and push with your legs instead of your arms.The gap narrows. She screams... a sound that fills the stone chamber and bounces off every wall. Her fingers pull back. Then, slower and more deliberate, she tries again. She is thinking. That is worse than the rage.

Somewhere above, distant and uncertain, a bird calls once and falls silent.

>hold
(the Sarcophagus)
That's fixed in place.

>hold the lid
She gives one final push and something tears in your shoulder. The lid moves. It moves too far. The gap opens two inches, three, four  and her fingers are inside it, both hands now, pulling, and your legs are shaking and your shoulder is wrong in a way you cannot fix and the stone keeps grinding. The lid comes off.

She is above you before you can raise the sword. The last thing you see clearly is her face. The eyes, wrong, and beneath them the face of a girl, fourteen years old, who does not know what she is doing and cannot stop.

The sarcophagus fills with dark.

    *** You held the line until your body gave out. You should have sealed the lid. Learn about you Magical Signs. ***

Would you like to RESTART, RESTORE a saved game, QUIT or UNDO the last command?

* * *

>wait
Time passes.

You hear a sudden, sharp scrape of stone on stone. The breathing stops. Before you can move, a weight slams into the floor nearby, and a high, piercing shriek echoes off the chamber walls. You are no longer alone in the dark. The thing is no longer inside the box. You can attack the thing or try to run or pray...

>go north
You try to react, swinging your arms in the pitch black, but you are far too slow for a creature of the night. You feel a heavy weight slam into your chest, pinning you against the cold stone wall. A wet, hot breath hits your neck, and then searing pain. Your throat is torn open before you can even scream.

    *** Witchers who cannot see their prey do not live long. You should have drunk a Cat Potion. Find a herbalist! ***

Would you like to RESTART, RESTORE a saved game, QUIT or UNDO the last command?

* * *

>wait
Time passes.

You hear a sudden, sharp scrape of stone on stone. The breathing stops. Before you can move, a weight slams into the floor nearby, and a high, piercing shriek echoes off the chamber walls. You are no longer alone in the dark. The thing is no longer inside the box. You can attack the thing or try to run or pray...

>hide
What do you want to hide in?

>hide in the box
For some reason, you think about entering the box... With a quick step, you go inside and start moving the lid to close yourself in. But you still need to, somehow, guarantee that she does not open it.

>cast yrden
You lay your sword on your chest and raise one hand to the stone slab above you. In the dark of the sarcophagus you trace the Yrden sign on the inside of the lid. The lines settle into something you feel more than see... a faint warmth against cold stone, a stillness that seeps down through the slab. You should wait or brace yourself.

>wait
Inside the silence is complete. The sign on the lid hums faintly against your palm. Outside, there is still roars. She is angry... You lie still. Your sword rests on your chest. You breathe slowly and wait. The smell of stone. The smell of old death. The smell of something almost over.

Somewhere above, distant and uncertain, a cock calls once and falls silent.

>brace
She gives one final push, but this time something is wrong. The force behind it is less than it should be. Through the stone, you can feel it... she is slowing. The Yrden sign has done its work, sapping the violence from her and turning her strength into confusion. She presses against the lid once, twice, weakly, like a creature that has forgotten why it is fighting. Then, she stops. The pressure vanishes. You fall into a deep state of mind, almost meditating... You could get out now to see if the curse is lifted, or you could stay inside.

The cock crows for the second time...

>get out
You decide you have had enough of the dark. Gritting your teeth, you push the lid aside and sit up, your muscles screaming in protest. The heavy stone grinds open, and, for a moment, there is only silence. Then, a shadow falls over the sarcophagus. She is waiting for you. The curse is not yet broken, and your movement has only given her the opening she needed. Before you can even level your silver sword, her claws are at your throat. The dawn is so close, but for you, it will never come. Somewhere far above, a cock crows, but you are no longer there to hear it.

    *** You left the safety of the stone too soon. Patience is as much a Witcher's weapon as his sword. ***

Would you like to RESTART, RESTORE a saved game, QUIT or UNDO the last command?

>go north
Please give one of the answers above.

Would you like to RESTART, RESTORE a saved game, QUIT or UNDO the last command?

>go west
Please give one of the answers above.

Would you like to RESTART, RESTORE a saved game, QUIT or UNDO the last command?

* * *

>hide
What do you want to hide in?

>hide it
I didn't understand that sentence.

>hide in box
For some reason, you think about entering the box... With a quick step, you go inside and start moving the lid to close yourself in. But you still need to, somehow, guarantee that she does not open it, maybe by holding the lid?

>hide
What do you want to hide in?

>hold lid
She throws her full weight against the lid and for a terrifying moment it moves, grinding open a full inch before you force it back. You wedge your boots against the far end of the sarcophagus and push with your legs instead of your arms.The gap narrows. She screams... a sound that fills the stone chamber and bounces off every wall. Her fingers pull back. Then, slower and more deliberate, she tries again. She is thinking. That is worse than the rage.

Somewhere above, distant and uncertain, a bird calls once and falls silent.

>hold lid
She gives one final push and something tears in your shoulder. The lid moves. It moves too far. The gap opens two inches, three, four  and her fingers are inside it, both hands now, pulling, and your legs are shaking and your shoulder is wrong in a way you cannot fix and the stone keeps grinding. The lid comes off.

She is above you before you can raise the sword. The last thing you see clearly is her face. The eyes, wrong, and beneath them the face of a girl, fourteen years old, who does not know what she is doing and cannot stop.

The sarcophagus fills with dark.

    *** You held the line until your body gave out. You should have sealed the lid. Learn about you Magical Signs... Examine them! ***

Would you like to RESTART, RESTORE a saved game, QUIT or UNDO the last command?

* * *

>wait
Time passes.

You hear a sudden, sharp scrape of stone on stone. The breathing stops. Before you can move, a weight slams into the floor nearby, and a high, piercing shriek echoes off the chamber walls. You are no longer alone in the dark. The thing is no longer inside the box. You can attack the thing or try to run or pray...

>hide in box
For some reason, you think about entering the box... With a quick step, you go inside and start moving the lid to close yourself in. But you still need to, somehow, guarantee that she does not open it, maybe by holding the lid?

>yrden
You lay your sword on your chest and raise one hand to the stone slab above you. In the dark of the sarcophagus you trace the Yrden sign on the inside of the lid. The lines settle into something you feel more than see... a faint warmth against cold stone, a stillness that seeps down through the slab. You should wait or brace yourself.

>wait
Inside the silence is complete. The sign on the lid hums faintly against your palm. Outside, there is still roars. She is angry... You lie still. Your sword rests on your chest. You breathe slowly and wait. The smell of stone. The smell of old death. The smell of something almost over.

Somewhere above, distant and uncertain, a cock calls once and falls silent.

>wait
She gives one final push, but this time something is wrong. The force behind it is less than it should be. Through the stone, you can feel it... she is slowing. The Yrden sign has done its work, sapping the violence from her and turning her strength into confusion. She presses against the lid once, twice, weakly, like a creature that has forgotten why it is fighting. Then, she stops. The pressure vanishes. You fall into a deep state of mind, almost meditating... You could get out now to see if the curse is lifted, or you could stay inside.

The cock crows for the second time...

* * *

>carry it
You carry the girl up to the main hall, then out through the palace doors into the courtyard. The morning air is cool and clean after the vaults. Velerad is already waiting at the gate. He did not sleep. He sees you, sees the girl, and his face does something complicated... relief and grief and something else.

"Is she..." he starts. "Alive," you say. "The curse is broken.". Velerad takes the girl from your arms carefully, as though she might shatter. She does not wake. She breathes. "The king will want to see her." His voice is rough. You accept the purse of coin he hands you. The contract is fulfilled.

"Witcher," Velerad says, as you turn to go. "Will she be... herself again?" You look at the girl in his arms. Fourteen years in a crypt. Seven of them not quite human. What comes back from that, you do not know. You have done what you were paid to do."She will be alive," you say. "That is the start."

You walk back through the market as the city wakes around you. Someone with sharp eyes recognizes what you are. No one says anything. Three thousand oren in your pocket. Your horse waiting at The Fox. Time to move on.

    *** The curse is lifted. Adda lives. You ride north. To your destiny. To the Law of Surprise... The Elder Blood... You blink and think on this thoughts. Maybe there will be a chance where you will invoke the famous Law of Surprise, just like some witchers did in the past! Your destiny is forth! ***

Would you like to RESTART, RESTORE a saved game, QUIT or UNDO the last command?

>restart
They said the man came from the north, through Roper's Gate. He came on foot, leading his laden horse by the bridle. The street lay empty. The day was hot, yet the man wore a black coat thrown over his shoulders, as though the heat meant nothing to him. He drew attention to himself. With a heavy, unhurried stride, the stranger shifted the two swords strapped across his back. Though hidden beneath the coat, their shape remained unmistakable. He was not old, though his hair was white as a dead man's. White as bone.

A boy, peering between the slats of a fence, tugged at his mother's sleeve.

"Mama... that man carries two swords on his back. Like a bow."

His mother pulled him closer without looking.

"People say witchers always carry two swords," she murmured. "One for men. One for monsters." She paused. "They say some can't tell the difference anymore."

The Witcher
An Interactive Fiction by António Alves
Release 1 / Serial number 260323 / Inform 7 v10.1.2 / D

Crossroads
You stand in front of the Old Narakort Inn, facing north. You spend a few seconds looking at the entrance, listening to the hubbub of voices. The Inn is full of people who may get the wrong impression of you. Farther down the street there is a smaller inn named The Fox, facing south. It is quite empty. You think about a contract you could make and a place to sleep when the night falls. Maybe a quiet place is a good option.

You see a wad of white goat leather nailed to the wood near the entrance, with some runes written on it. You already saw the same leather across the road, on notice boards.

>go south
You push open the door of The Fox. The hinges creak. Inside, it is dim and quiet. Just the way you like it.

Fox Inn
The Fox is quiet. A few candles burn low on the tables. The innkeeper glances up at you without alarm. He has seen worse, or at least pretends he has. This will do. The innkeeper eyes the hilt of your sword and then your face. He opens his mouth, thinks better of it, closes it again. He looks like a man with something heavy on his chest.

The innkeeper is a broad-shouldered man with a trimmed grey beard and careful eyes. He keeps his hands on the bar, easy and visible. You can ask for a room to stay the night.

* * *

>go north
Castle Keep
The castle is old and smells of damp stone and old candles. Guards eye you at the gate but let you pass. They know the look of someone who has come about the contract. Inside, the keep is dim, the tapestries faded. Velerad's office is at the end of the main corridor.

Velerad is a heavyset man in his fifties with a soldier's posture and a bureaucrat's tired eyes. He sits behind a broad desk covered in papers. You should talk with him!

A rolled map of the palace district lies on the corner of Velerad's desk.

A stiff parchment with Velerad's seal and the terms of the commission.

>go down
You can't go that way.

>go north
You can't go that way.

>go down
You can't go that way.

* * *

>go east
The palace gate stands closed. The guards notices you. "Hey you!" but you notice also that they are nervous or almost terrified. For sure they don't want to be there. They notice the two swords and say, "Oh... haha, well you are witcher aint you? We can let you pass but we will not check on you!" You go through without a word.

Inside the courtyard, the silence hits you first. No insects. No birds. Nothing wants to be near this place after dark. Maybe you should prepare before going further... Check your swords and signs.

Ruined Courtyard
The palace courtyard is a ruin. Weeds push through the paving. A fountain has long since gone dry, its basin full of dead leaves. The main doors of the palace hang open and they have not been properly closed in years. The windows above are dark. Something has broken most of them from the inside. It is very quiet. The main hall waits ahead.

There is a stone fountain, ornate once, now cracked and dry. The basin is filled with old leaves and what might be old bloodstains, gone brown.

The upper windows of the palace are all broken, most from the inside, and shards of old glass lie on the ledges and the courtyard below.

* * *

>go east
Eastern Chamber
You cannot see. The room is cold. The floor under your boots has changed from bare stone to something that crunches faintly... old debris, small bones perhaps. The air in here is different from the corridor, enclosed... Something large at the centre of the room, something your outstretched hand finds at shoulder height. Stone, cold, rough-edged. A box. Very large and very old.

There is a heavy stone box, very large and very old...

Something inside the stone box breathes. You freeze. It has not heard you. Or it does not care...

>see it
You hear a sudden, sharp scrape of stone on stone. The breathing stops. Before you can move, a weight slams into the floor nearby, and a high, piercing shriek echoes off the chamber walls. You are no longer alone in the dark. The thing is no longer inside the box. You can attack the thing or try to run or pray...

>hide in it
For some reason, you think about entering the box... With a quick step, you go inside and start moving the lid to close yourself in. But you still need to, somehow, guarantee that she does not open it, maybe by holding the lid?

>yrden
You lay your sword on your chest and raise one hand to the stone slab above you. In the dark of the sarcophagus you trace the Yrden sign on the inside of the lid. The lines settle into something you feel more than see... a faint warmth against cold stone, a stillness that seeps down through the slab. You should wait or brace yourself.

* * *

>wait
Time passes.

>carry the girl to the Palace Vaults
You carry the girl up to the main hall, then out through the palace doors into the courtyard. The morning air is cool and clean after the vaults. Velerad is already waiting at the gate. He did not sleep. He sees you, sees the girl, and his face does something complicated... relief and grief and something else.

"Is she..." he starts. "Alive," you say. "The curse is broken.". Velerad takes the girl from your arms carefully, as though she might shatter. She does not wake. She breathes. "The king will want to see her." His voice is rough. You accept the purse of coin he hands you. The contract is fulfilled.

"Witcher," Velerad says, as you turn to go. "Will she be... herself again?" You look at the girl in his arms. Fourteen years in a crypt. Seven of them not quite human. What comes back from that, you do not know. You have done what you were paid to do."She will be alive," you say. "That is the start."

You walk back through the market as the city wakes around you. Someone with sharp eyes recognizes what you are. No one says anything. Three thousand oren in your pocket. Your horse waiting at The Fox. Time to move on.

    *** The curse is lifted. Adda lives. You ride north. To your destiny. To the Law of Surprise... The Elder Blood... You blink and think on this thoughts. Maybe there will be a chance where you will invoke the famous Law of Surprise, just like some witchers did in the past! Your destiny is forth! ***

Would you like to RESTART, RESTORE a saved game, QUIT or UNDO the last command?

>restart
They said the man came from the north, through Roper's Gate. He came on foot, leading his laden horse by the bridle. The street lay empty. The day was hot, yet the man wore a black coat thrown over his shoulders, as though the heat meant nothing to him. He drew attention to himself. With a heavy, unhurried stride, the stranger shifted the two swords strapped across his back. Though hidden beneath the coat, their shape remained unmistakable. He was not old, though his hair was white as a dead man's. White as bone.

A boy, peering between the slats of a fence, tugged at his mother's sleeve.

"Mama... that man carries two swords on his back. Like a bow."

His mother pulled him closer without looking.

"People say witchers always carry two swords," she murmured. "One for men. One for monsters." She paused. "They say some can't tell the difference anymore."

The Witcher
An Interactive Fiction by António Alves
Release 1 / Serial number 260323 / Inform 7 v10.1.2 / D

Crossroads
You stand in front of the Old Narakort Inn, facing north. You spend a few seconds looking at the entrance, listening to the hubbub of voices. The Inn is full of people who may get the wrong impression of you. Farther down the street there is a smaller inn named The Fox, facing south. It is quite empty. You think about a contract you could make and a place to sleep when the night falls. Maybe a quiet place is a good option.

You see a wad of white goat leather nailed to the wood near the entrance, with some runes written on it. You already saw the same leather across the road, on notice boards.

* * *

>wait
Time passes.

You hear a sudden, sharp scrape of stone on stone. The breathing stops. Before you can move, a weight slams into the floor nearby, and a high, piercing shriek echoes off the chamber walls. You are no longer alone in the dark. The thing is no longer inside the box. You can attack the thing or try to run or pray...

>wait
You try to react, swinging your arms in the pitch black, but you are far too slow for a creature of the night. You feel a heavy weight slam into your chest, pinning you against the cold stone wall. A wet, hot breath hits your neck, and then searing pain. Your throat is torn open before you can even scream.

    *** Witchers who cannot see their prey do not live long. You should have drunk a Cat Potion. Find a herbalist! ***

Would you like to RESTART, RESTORE a saved game, QUIT or UNDO the last command?

>wait
Please give one of the answers above.

Would you like to RESTART, RESTORE a saved game, QUIT or UNDO the last command?

* * *

>wait
You wait for the unexpected... yet you remain still. Why?

>go east
Eastern Chamber
You cannot see. The room is cold. The floor under your boots has changed from bare stone to something that crunches faintly... old debris, small bones perhaps. The air in here is different from the corridor, enclosed... Something large at the centre of the room, something your outstretched hand finds at shoulder height. Stone, cold, rough-edged. A box. Very large and very old.She is in here. You can hear her. A low sound, not quite animal, closer to something in pain. Movement near the large stone object at the room's centre. She is not attacking. Not yet.

There is a heavy stone box, very large and very old...

Something inside the stone box breathes. You freeze. It has not heard you. Or it does not care...

You hear a sudden, sharp scrape of stone on stone. The breathing stops. Before you can move, a weight slams into the floor nearby, and a high, piercing shriek echoes off the chamber walls. You are no longer alone in the dark.

>go north
You can't go that way.

* * *

>go west
Palace Vaults
The stairs end in darkness. Absolute darkness. You stop on the bottom step and hold still, letting your other senses work. The air is cold. Old. A smell like stone and something that has been alive a long time in a confined space. The floor is grit and old dust beneath your boots. You can hear the shape of the vault in the way sound does not travel. You cannot see. You move carefully.

The vault is empty. She has gone out.You hear her. Close. A sound between breathing and growling, just ahead in the dark. You cannot tell exactly where.

* * *

>wait
You wait for the unexpected... yet you remain still. Why?

Something moves in the dark ahead of you. The slow breathing stops. Stone grinds on stone. Then comes a sound you have no name for. The air shifts, and something starts entering the corridor. Move toward the sound, unless you mean to die. You have the disadvantage in the corridor.

>examine it
You try to identify where the sound is coming from. You move very slowly, but before you have time to react, you see claws driving straight into your face. You fall to the ground, seeing only pitch black. You cannot breathe; your throat has been slashed by the monster's nails.

    *** You should have prepared more... Witchers are always cautious and keep a Cat Potion with them at all times. You should explore further to find a herbalist. ***

Would you like to RESTART, RESTORE a saved game, QUIT or UNDO the last command?

* * *

>wait
You wait for the unexpected... yet you remain still. Why?

Something moves in the dark ahead of you. The slow breathing stops. Stone grinds on stone. Then comes a sound you have no name for. The air shifts, and something starts entering the corridor. Move toward the sound, unless you mean to die. You have the disadvantage in the corridor.

>fight
What do you want to fight?

>fight it
You try to identify where the sound is coming from. You move very slowly, but before you have time to react, you see claws driving straight into your face. You fall to the ground, seeing only pitch black. You cannot breathe; your throat has been slashed by the monster's nails.

    *** You should have prepared more... Witchers are always cautious and keep a Cat Potion with them at all times. You should explore further to find a herbalist. ***

Would you like to RESTART, RESTORE a saved game, QUIT or UNDO the last command?

>fight the thing
Please give one of the answers above.

Would you like to RESTART, RESTORE a saved game, QUIT or UNDO the last command?

>go up
Please give one of the answers above.

Would you like to RESTART, RESTORE a saved game, QUIT or UNDO the last command?

* * *

>wait
You wait for the unexpected... yet you remain still. Why?

Something moves in the dark ahead of you. The slow breathing stops. Stone grinds on stone. Then comes a sound you have no name for. The air shifts, and something starts entering the corridor. Move toward the sound, unless you mean to die. You have the disadvantage in the corridor.

>wait
You try to identify where the sound is coming from. You move very slowly, but before you have time to react, you see claws driving straight into your face. You fall to the ground, seeing only pitch black. You cannot breathe; your throat has been slashed by the monster's nails.

    *** You should have prepared more... Witchers are always cautious and keep a Cat Potion with them at all times. You should explore further to find a herbalist. ***

Would you like to RESTART, RESTORE a saved game, QUIT or UNDO the last command?

* * *

>go to place vaults
You can't see any such thing.

>go north
Old Palace Hall
The main hall is vast and hollow. Moonlight falls through the broken roof in pale columns, lighting nothing useful. Dust on the floor, disturbed in a path that leads from the far end of the hall, from the direction of the stairs going down, and across to the main doors. The path of something that moves on all fours, and then on two legs, and then on all fours again. The stairs to the vault are at the far end, going down. It is quiet. She is still below.

There is a trail worn into the dust of the floor, leading from the vault stairs to the main doors.

* * *

>examine it
You hear a sudden, sharp scrape of stone on stone. The breathing stops. Before you can move, a weight slams into the floor nearby, and a high, piercing shriek echoes off the chamber walls. You are no longer alone in the dark. The thing is no longer inside the box. You can attack the thing or try to run or pray...

>hide
What do you want to hide in?

>hide in the box
For some reason, you think about entering the box... With a quick step, you go inside and start moving the lid to close yourself in. But you still need to, somehow, guarantee that she does not open it, maybe by holding the lid?

* * *

>cast yrden
You lay your sword on your chest and raise one hand to the stone slab above you. In the dark of the sarcophagus you trace the Yrden sign on the inside of the lid. The lines settle into something you feel more than see... a faint warmth against cold stone, a stillness that seeps down through the slab. You should wait or brace yourself.

>brace
She gives one final push, but this time something is wrong. The force behind it is less than it should be. Through the stone, you can feel it... she is slowing. The Yrden sign has done its work, sapping the violence from her and turning her strength into confusion. She presses against the lid once, twice, weakly, like a creature that has forgotten why it is fighting. Then, she stops. The pressure vanishes. You fall into a deep state of mind, almost meditating... You could get out now to see if the curse is lifted, or you could stay inside.

The cock crows for the second time...

* * *

>go south
Herbalist's Shop
A low building that smells of dried things like herbs, roots, something sharper beneath. Bundles of plants hang from every rafter.

The herbalist is a small woman of indeterminate age. Her hands are stained with various dyes and preparations, and she does not look up from her work when you enter. You should ask her about the monster.

There is a black potion here. Small dark vial stoppered with wax. It smells faintly of something rotten.

There is another potion in small amber vial. It smells sharp and clean.

>take both
Black Blood Potion: The herbalist raises her head. "Why don't you talk to me first before start taking my stuff?" You know that you are being stupid... This is not your way of doing things...
Cat Potion: The herbalist raises her head. "Why don't you talk to me first before start taking my stuff?" You know that you are being stupid... This is not your way of doing things...

>inventory
You are carrying:
  a Silver Sword
  an Iron Sword
  a Magical Signs Tome

>talk to her
I didn't understand that sentence.

>talke with her
That's not a verb I recognise.

>talk with her
I didn't understand that sentence.

>ask her about it
She looks up at last.

"Velerad's witcher.". She says it flatly. "I know what you need. A Black Blood potion. Toxic to things that feed on human blood. They bite the drinker, they suffer for it.". She sets a small dark vial on the counter. "And Cat. For the dark. The palace vaults have no lanterns.". She adds a second vial, this one amber. You know the last one off course... The Black Blood is important, if the striga bites you, the poison passes to it. Slows it. It will not kill the creature, but it will weaken it." She names a price. It is not unreasonable. "Take both," she says. "Come back alive so I know if they worked.

 You should follow what she says. Take both potions and examine them."

>take both
Black Blood Potion: You pocket the Black Blood potion carefully.
Cat Potion: You pocket the Cat potion. You will drink it before you go in.

>inventory
You are carrying:
  a Cat Potion
  a Black Blood Potion
  a Silver Sword
  an Iron Sword
  a Magical Signs Tome

>go north
Market Square
The market is winding down for the evening. Stall holders roll up their cloth and argue over the day's takings. At the far end, a barber is still open, with his red and white pole catching the last of the light. On the opposite side, a merchant with silver streaked hair sits at a tavern table with a cup that never seems to empty.

The Barber is a thin and a fidgety man with nimble fingers and has restless eyes. He has the barber's habit of talking to fill silence, or to play the role of an unsolicited therapist. 

The merchant is a broad, well dressed man who seems entirely too comfortable for someone living in a city with a monster problem. He has the look of a man who has learned that gold can buy distance from most troubles. 

On the wall at the northern end of the market, near the palace gate, someone has scratched a crude calendar into the stone. Fourteen years worth of marks, each month noted. And beside the seventh year, a different mark, a rough shape like a curled, sleeping figure, and beside it an arrow pointing east. Toward the palace.

>go east
The palace gate stands closed. The guards notices you. "Hey you!" but you notice also that they are nervous or almost terrified. For sure they don't want to be there. They notice the two swords and say, "Oh... haha, well you are witcher aint you? We can let you pass but we will not check on you!" You go through without a word.

Inside the courtyard, the silence hits you first. No insects. No birds. Nothing wants to be near this place after dark. Maybe you should prepare before going further... Check your swords and signs.

Ruined Courtyard
The palace courtyard is a ruin. Weeds push through the paving. A fountain has long since gone dry, its basin full of dead leaves. The main doors of the palace hang open and they have not been properly closed in years. The windows above are dark. Something has broken most of them from the inside. It is very quiet. The main hall waits ahead.

There is a stone fountain, ornate once, now cracked and dry. The basin is filled with old leaves and what might be old bloodstains, gone brown.

The upper windows of the palace are all broken, most from the inside, and shards of old glass lie on the ledges and the courtyard below.

* * *

>drink cat potion
You uncork the Cat potion and drink it in one swallow. Bitter as ash. For a moment the world dims, and then snaps back sharper than before. The dark is grey instead of black, shapes clear and distinct. You can see. Your cat eyes... are different.

Now you can see... The stairs end in grey half-light. The cat potion does its work. The vault is a long, low corridor with a stoned floor. Several chambers open off it. The eastern chamber lies at the far end. The air is cold and carries something that is not rot and not animal but is both and neither.

>drink black potion
You uncork the Black Blood potion and drink it in one swallow. It has no taste. Nothing. Then the cold sets in, spreading from your chest outward and slow. You look down at your arm and you see the veins beneath the skin are darker, nearly black. The potion is in you now. When she bites, she will taste it. You just need to let her get close enough. But that is only half the problem, you still need to find a way to last until dawn.

A sound from the eastern chamber, stone grinding on stone and then silence. Then the smell changes.

She is awake. You should move to the chamber, this corridor is too straight. You have the disadvantage here.

>go east
Eastern Chamber
A stone chamber. In the centre stands the sarcophagus, a heavy grey stone, its lid displaced, scored with deep claw marks along every edge. The smell is strong here. Old. Wrong.

 There is a heavy stone sarcophagus with its lid partially displaced. The stone around the edges is scored with claw marks, deep and repetitive, the work of years.

You move toward the source of the sound. There she is, standing in the middle of the chamber. You cannot kill her. You need to weaken her somehow and survive the night with her until dawn. You will need to think of something clever or you will not last until dawn otherwise. Check your surroundings! Use your silver sword and signs.

>aard
You cast Aard. The Striga is hurled several meters back, buying you a moment to think. You need to weaken her somehow.
Your blood is darker now. You can feel it. Wait for her to come to you.

>aard
You cast Aard. The Striga is hurled several meters back, buying you a moment to think. You need to weaken her somehow... Check your inventory. Do you have something that could weaken her? Perhaps related to your blood?

>wait
You steady yourself. You know you need to wait for her attack, but you cannot let her go for your throat or anywhere vital. She launches herself at you and you shift left at the last moment, leaving your arm in front of her mouth. She bites down. The pain is sharp and immediate, but your witcher training takes over, your body pushes it aside before your mind has time to register it.

She is slowing down. The Black Blood is working. This is your chance to finish her... But you will not receive the orens and you will be wanted by the crown of Foltest. You need to hide until dawn. Where can you go?

>finish her
With you silver sword on your hand, you walk twoards her. You raise your silver sword. One clean strike. It would be over... You do it.

The vault goes quiet. You stand there for a moment, listening to the silence. Then you hear boots on the stairs. Two guards, then four, then Velerad himself, lantern in hand. He takes in the scene. The broken sarcophagus. The sword in your hand. The stillness. His face closes like a door.

"You were told," he says. Quietly. That is worse than shouting. They take your swords first. Then your coin. The trial is brief since the king does not want a spectacle. The sentence is read in a hall you will never leave.

Three thousand oren. That was all it would have taken.

    *** You killed the king's daughter. Wyzim is the last city you will ever see. ***

Would you like to RESTART, RESTORE a saved game, QUIT or UNDO the last command?

* * *

>look wad
You get closer and see that it is a proclamation, signed by Foltest, King of Temeria, Pontar and Mahakam... You might want to examine it further to read the details.

>look it
You read the proclamation carefully:

"BY ORDER OF KING FOLTEST OF TEMERIA

Let it be known to all citizens of Wyzim and its surroundings:

The palace district is hereby forbidden to all persons, by penalty of death. None shall enter, none shall linger after dark.

A creature of unknown nature dwells within the old palace vaults. It is dangerous. It kills. Fourteen years have passed since the curse was laid and seven since it first stirred.

His Majesty King Foltest, in his mercy, forbids any attempt upon the creature's life.

His Majesty hereby calls upon any man of skill and knowledge, witcher, sorcerer, or wise man, who believes themselves capable of lifting the curse upon the creature, to present themselves before the castellan Velerad at Wyzim.

Any man or woman capable of lifting the curse without harm to the creature shall be rewarded handsomely by the crown with three thousand oren.

Those who attempt to destroy the creature instead of breaking the spell will be tried for treason."

You think about pulling it off in case you need to ask about it.

* * *

>nigga
That's not a verb I recognise.

>go to inn
You can't see any such thing.

>go south
You push open the door of The Fox. The hinges creak. Inside, it is dim and quiet. Just the way you like it.

Fox Inn
The Fox is quiet. A few candles burn low on the tables. The innkeeper glances up at you without alarm. He has seen worse, or at least pretends he has. This will do. The innkeeper eyes the hilt of your sword and then your face. He opens his mouth, thinks better of it, closes it again. He looks like a man with something heavy on his chest.

The innkeeper is a broad-shouldered man with a trimmed grey beard and careful eyes. He keeps his hands on the bar, easy and visible. You can ask for a room to stay the night.

>go north
Crossroads
You stand in front of the Old Narakort Inn, facing north. You spend a few seconds looking at the entrance, listening to the hubbub of voices. The Inn is full of people who may get the wrong impression of you. Farther down the street there is a smaller inn named The Fox, facing south. It is quite empty. You think about a contract you could make and a place to sleep when the night falls. Maybe a quiet place is a good option.

You see a wad of white goat leather nailed to the wood near the entrance, with some runes written on it. You already saw the same leather across the road, on notice boards.

>go north
You push the door open and step inside.

Old Narakort Inn
You step inside. The smell of ale and sweat hits you first. The room is loud and packed. Farmers, merchants, a few armed men. The conversation dies the moment you cross the threshold. Every pair of eyes is on you. On your swords... On your eyes... Someone mutters something. Then another voice, louder: "We don't want your kind here, witcher."

You can drink, wait for something, even move or stay put. You think about leaving so you don't get into a fight for nothing.

A group of men sit hunched over their tankards, watching you with open hostility.

>move
Before you can settle in, two large men grab you by the arms and haul you toward the door. "Get out, freak," one of them growls. You do not resist. There is nothing here worth a fight.

You are back on the street.

Crossroads
You stand in front of the Old Narakort Inn, facing north. You spend a few seconds looking at the entrance, listening to the hubbub of voices. The Inn is full of people who may get the wrong impression of you. Farther down the street there is a smaller inn named The Fox, facing south. It is quite empty. You think about a contract you could make and a place to sleep when the night falls. Maybe a quiet place is a good option.

You see a wad of white goat leather nailed to the wood near the entrance, with some runes written on it. You already saw the same leather across the road, on notice boards.

>go north
You push the door open and step inside.

Old Narakort Inn
You step inside. The smell of ale and sweat hits you first. The room is loud and packed. Farmers, merchants, a few armed men. The conversation dies the moment you cross the threshold. Every pair of eyes is on you. On your swords... On your eyes... Someone mutters something. Then another voice, louder: "We don't want your kind here, witcher."

You can drink, wait for something, even move or stay put. You think about leaving so you don't get into a fight for nothing.

A group of men sit hunched over their tankards, watching you with open hostility.

>drink
Before you can settle in, two large men grab you by the arms and haul you toward the door. "Get out, freak," one of them growls. You do not resist. There is nothing here worth a fight.

You are back on the street.

Crossroads
You stand in front of the Old Narakort Inn, facing north. You spend a few seconds looking at the entrance, listening to the hubbub of voices. The Inn is full of people who may get the wrong impression of you. Farther down the street there is a smaller inn named The Fox, facing south. It is quite empty. You think about a contract you could make and a place to sleep when the night falls. Maybe a quiet place is a good option.

You see a wad of white goat leather nailed to the wood near the entrance, with some runes written on it. You already saw the same leather across the road, on notice boards.

* * *

>wait
Time passes.

>wait
Time passes.

>stay put
I only understood you as far as wanting to stay.

>stay
Before you can settle in, two large men grab you by the arms and haul you toward the door. "Get out, freak," one of them growls. You do not resist. There is nothing here worth a fight.

You are back on the street.

Crossroads
You stand in front of the Old Narakort Inn, facing north. You spend a few seconds looking at the entrance, listening to the hubbub of voices. The Inn is full of people who may get the wrong impression of you. Farther down the street there is a smaller inn named The Fox, facing south. It is quite empty. You think about a contract you could make and a place to sleep when the night falls. Maybe a quiet place is a good option.

You see a wad of white goat leather nailed to the wood near the entrance, with some runes written on it. You already saw the same leather across the road, on notice boards.

>go south
You push open the door of The Fox. The hinges creak. Inside, it is dim and quiet. Just the way you like it.

Fox Inn
The Fox is quiet. A few candles burn low on the tables. The innkeeper glances up at you without alarm. He has seen worse, or at least pretends he has. This will do. The innkeeper eyes the hilt of your sword and then your face. He opens his mouth, thinks better of it, closes it again. He looks like a man with something heavy on his chest.

The innkeeper is a broad-shouldered man with a trimmed grey beard and careful eyes. He keeps his hands on the bar, easy and visible. You can ask for a room to stay the night.

>go east
Market Square
The market is winding down for the evening. Stall-holders roll up their cloth and argue over the day's takings. At the far end, a barber is still open, his red-and-white pole catching the last of the light. On the opposite side, a merchant with silver-streaked hair sits at a tavern table with a cup that never seems to empty.

The Barber is thin and a fidgety man with nimble fingers and restless eyes. He has the barber's habit of talking to fill silence, or to play the role of an unsolicited therapist. You can try and ask him about the proclamation.

The merchant is a broad, well-dressed man who seems entirely too comfortable for someone living in a city with a monster problem. He has the look of a man who has learned that gold can buy distance from most troubles. You can try and aks him about the proclamation.

On the wall at the northern end of the market, near the palace gate, someone has scratched a crude calendar into the stone. Fourteen years worth of marks, each month noted. And beside the seventh year, a different mark, a rough shape like a curled, sleeping figure, and beside it an arrow pointing east. Toward the palace.

>go east
The palace gate stands closed. The guards notices you. "Hey you!" but you notice also that they are nervous or almost terrified. For sure they don't want to be there. They notice the two swords and say, "Oh... haha, well you are witcher aint you? We can let you pass but we will not check on you!" You go through without a word.

Inside the courtyard, the silence hits you first. No insects. No birds. Nothing wants to be near this place after dark. Maybe you should prepare before going further.

Ruined Courtyard
The palace courtyard is a ruin. Weeds push through the paving. A fountain has long since gone dry, its basin full of dead leaves. The main doors of the palace hang open and they have not been properly closed in years. The windows above are dark. Something has broken most of them from the inside. It is very quiet. The main hall waits ahead.

There is a stone fountain, ornate once, now cracked and dry. The basin is filled with old leaves and what might be old bloodstains, gone brown.

The upper windows of the palace are all broken, most from the inside, and shards of old glass lie on the ledges and the courtyard below.

>go west
Market Square
The market is winding down for the evening. Stall-holders roll up their cloth and argue over the day's takings. At the far end, a barber is still open, his red-and-white pole catching the last of the light. On the opposite side, a merchant with silver-streaked hair sits at a tavern table with a cup that never seems to empty.

The Barber is thin and a fidgety man with nimble fingers and restless eyes. He has the barber's habit of talking to fill silence, or to play the role of an unsolicited therapist. You can try and ask him about the proclamation.

The merchant is a broad, well-dressed man who seems entirely too comfortable for someone living in a city with a monster problem. He has the look of a man who has learned that gold can buy distance from most troubles. You can try and aks him about the proclamation.

On the wall at the northern end of the market, near the palace gate, someone has scratched a crude calendar into the stone. Fourteen years worth of marks, each month noted. And beside the seventh year, a different mark, a rough shape like a curled, sleeping figure, and beside it an arrow pointing east. Toward the palace.

>go north
Castle Keep
The castle is old and smells of damp stone and old candles. Guards eye you at the gate but let you pass. They know the look of someone who has come about the contract. Inside, the keep is dim, the tapestries faded. Velerad's office is at the end of the main corridor.

Velerad is a heavyset man in his fifties with a soldier's posture and a bureaucrat's tired eyes. He sits behind a broad desk covered in papers.

A rolled map of the palace district lies on the corner of Velerad's desk.

A stiff parchment with Velerad's seal and the terms of the commission.

* * *

>examine map
Velerad whistles to you, with a wierd face that translates to something like "You come here and the first thing you do is looking at my belongings?".

>examine map
Velerad is not that happy. Is face is turning red. Maybe you should stop looking at his stuff before talking to him.

>examine map
Velerad is like: "This piece of sh**"... Maybe you should ask him about the proclamation first before examining the map.

* * *

>north
You push the door open and step inside.

Old Narakort Inn
You step inside. The smell of ale and sweat hits you first. The room is loud and packed. Farmers, merchants, a few armed men. The conversation dies the moment you cross the threshold. Every pair of eyes is on you. On your swords... On your eyes... Someone mutters something. Then another voice, louder: "We don't want your kind here, witcher."

A group of men sit hunched over their tankards, watching you with open hostility.

>move
Before you can settle in, two large men grab you by the arms and haul you toward the door. "Get out, freak," one of them growls. You do not resist. There is nothing here worth a fight.

You are back on the street.

Crossroads
You stand in front of the Old Narakort Inn, facing north. You spend a few seconds looking at the entrance, listening to the hubbub of voices. The Inn is full of people who may get the wrong impression of you. Farther down the street there is a smaller inn named The Fox, facing south. It is quite empty.

You see a wad of white goat leather nailed to the wood near the entrance, with some runes written on it. You already saw the same leather across the road.

* * *

>north
You push the door open and step inside.

Old Narakort Inn
You step inside. The smell of ale and sweat hits you first. The room is loud and packed. Farmers, merchants, a few armed men. The conversation dies the moment you cross the threshold. Every pair of eyes is on you. On your swords... On your eyes... Someone mutters something. Then another voice, louder: "We don't want your kind here, witcher."

A group of men sit hunched over their tankards, watching you with open hostility.

>south
You step back out into the street.

Crossroads
You stand in front of the Old Narakort Inn, facing north. You spend a few seconds looking at the entrance, listening to the hubbub of voices. The Inn is full of people who may get the wrong impression of you. Farther down the street there is a smaller inn named The Fox, facing south. It is quite empty.

You see a wad of white goat leather nailed to the wood near the entrance, with some runes written on it. You already saw the same leather across the road.

>north
You push the door open and step inside.

Old Narakort Inn
You step inside. The smell of ale and sweat hits you first. The room is loud and packed. Farmers, merchants, a few armed men. The conversation dies the moment you cross the threshold. Every pair of eyes is on you. On your swords... On your eyes... Someone mutters something. Then another voice, louder: "We don't want your kind here, witcher."

A group of men sit hunched over their tankards, watching you with open hostility.

* * *

>pull it
You pull the leather off the wood, roll it up and tuck it into your jerkin. This certainly will be useful later.

* * *

>examine it
You read the proclamation carefully:

"BY ORDER OF KING FOLTEST OF TEMERIA

Let it be known to all citizens of Wyzim and its surroundings:

The palace district is hereby forbidden to all persons, by penalty of death. None shall enter, none shall linger after dark.

A creature of unknown nature dwells within the old palace vaults. It is dangerous. It kills. Fourteen years have passed since the curse was laid and seven since it first stirred.

His Majesty King Foltest, in his mercy, forbids any attempt upon the creature's life.

His Majesty hereby calls upon any man of skill and knowledge, witcher, sorcerer, or wise man, who believes themselves capable of lifting the curse upon the creature, to present themselves before the castellan Velerad at Wyzim.

Any man or woman capable of lifting the curse without harm to the creature shall be rewarded handsomely by the crown with three thousand oren.

Those who attempt to destroy the creature instead of breaking the spell will be tried for treason."

>go north
You push the door open and step inside.

Old Narakort Inn
You step inside. The smell of ale and sweat hits you first. The room is loud and packed. Farmers, merchants, a few armed men. The conversation dies the moment you cross the threshold. Every pair of eyes is on you. On your swords... On your eyes... Someone mutters something. Then another voice, louder: "We don't want your kind here, witcher."

You can drink, wait for something, even move or stay put. You think about leaving so you don't get into a fight for nothing.

A group of men sit hunched over their tankards, watching you with open hostility.

* * *

>go south
You step back out into the street.

Crossroads
You stand in front of the Old Narakort Inn, facing north. You spend a few seconds looking at the entrance, listening to the hubbub of voices. The Inn is full of people who may get the wrong impression of you. Farther down the street there is a smaller inn named The Fox, facing south. It is quite empty. You think about a contract you could make and a place to sleep when the night falls. Maybe a quiet place is a good option.

>go south
You push open the door of The Fox. The hinges creak. Inside, it is dim and quiet. Just the way you like it.

Fox Inn
The Fox is quiet. A few candles burn low on the tables. The innkeeper glances up at you without alarm. He has seen worse, or at least pretends he has. This will do. The innkeeper eyes the hilt of your sword and then your face. He opens his mouth, thinks better of it, closes it again. He looks like a man with something heavy on his chest.

The innkeeper is a broad-shouldered man with a trimmed grey beard and careful eyes. He keeps his hands on the bar, easy and visible. You can ask for a room to stay the night.  Or you could ask about the proclamation...

>kill
What do you want to kill?

* * *

>teste
That's not a verb I recognise.

* * *

>drink it
You must name something more substantial.

* * *

>pull it
You pull the leather off the wood, roll it up and tuck it into your jerkin. This certainly will be useful later.

>see it
You read the proclamation carefully:

"BY ORDER OF KING FOLTEST OF TEMERIA

Let it be known to all citizens of Wyzim and its surroundings:

The palace district is hereby forbidden to all persons, by penalty of death. None shall enter, none shall linger after dark.

A creature of unknown nature dwells within the old palace vaults. It is dangerous. It kills. Fourteen years have passed since the curse was laid and seven since it first stirred.

His Majesty King Foltest, in his mercy, forbids any attempt upon the creature's life.

His Majesty hereby calls upon any man of skill and knowledge, witcher, sorcerer, or wise man, who believes themselves capable of lifting the curse upon the creature, to present themselves before the castellan Velerad at Wyzim.

Any man or woman capable of lifting the curse without harm to the creature shall be rewarded handsomely by the crown with three thousand oren.

Those who attempt to destroy the creature instead of breaking the spell will be tried for treason."

>go north
You push the door open and step inside.

Old Narakort Inn
You step inside. The smell of ale and sweat hits you first. The room is loud and packed. Farmers, merchants, a few armed men. The conversation dies the moment you cross the threshold. Every pair of eyes is on you. On your swords... On your eyes... Someone mutters something. Then another voice, louder: "We don't want your kind here, witcher."

You can drink, wait for something, even move, stay put or maybe ask them about the lether you found outside.. You think about leaving so you don't get into a fight for nothing.

A group of men sit hunched over their tankards, watching you with open hostility.

>drink
Before you can settle in, two large men grab you by the arms and haul you toward the door. "Get out, freak," one of them growls. You do not resist. There is nothing here worth a fight.

You are back on the street.

Crossroads
You stand in front of the Old Narakort Inn, facing north. You spend a few seconds looking at the entrance, listening to the hubbub of voices. The Inn is full of people who may get the wrong impression of you. Farther down the street there is a smaller inn named The Fox, facing south. It is quite empty. You think about a contract you could make and a place to sleep when the night falls. Maybe a quiet place is a good option.

>go south
You push open the door of The Fox. The hinges creak. Inside, it is dim and quiet. Just the way you like it.

Fox Inn
The Fox is quiet. A few candles burn low on the tables. The innkeeper glances up at you without alarm. He has seen worse, or at least pretends he has. This will do. The innkeeper eyes the hilt of your sword and then your face. He opens his mouth, thinks better of it, closes it again. He looks like a man with something heavy on his chest.

The innkeeper is a broad-shouldered man with a trimmed grey beard and careful eyes. He keeps his hands on the bar, easy and visible. You can ask for a room to stay the night.  Or you could ask about the proclamation...

>ask the innkeeper about the proclamation
The innkeeper studies you a moment, then sets down the rag he was using to wipe the bar. "You have a desire to die I guess... Going to a place like Narakort.". He pauses.
 "You're a witcher, aren't you?" He does not wait for an answer. "I can always tell. The eyes... You... That white hair. Also the medallion. A wolf... from Kaer Mor... Something like that. You know, one called Vesemir had hair almost like yours. Maybe I should not ask about it. A lot of witchers pass here and some talk and I listen." He pours a cup of something dark and slides it across the counter without being asked. "I'll not throw you out," he says. "A man's coin is a man's coin. But..." He hesitates. "Have you seen the proclamation?"

He glances toward the door before he speaks again.
The innkeeper lowers his voice. "The proclamation on the gate. I expect you read it." He glances around the empty room, habit more than caution. "Fourteen years ago a curse fell on the old palace. The creature that lives in the vaults... folks say it is a terrible monster. A cursed thing, half woman, half beast. Kills without reason. Velerad, the king's castellan, he is the one offering the contract. His office is in the castle keep, north through the market. This market is not far from my inn. You should get there easily by just going east from here."

He refills your cup."I'll give you a room, witcher. Cheapest in Wyzim. Consider it goodwill. We could use someone who isn't afraid of that thing." He slides a key across the worn wood of the bar. You scoop it up, feeling the cold iron against your palm, and secure it in your pocket.

>examine yourself
You can't see any such thing.

>examine self
You are Geralt of Rivia. Witcher. White hair, cat's eyes, two swords. You have been in worse places than this.

You know: the creature in the palace is a striga. A cursed girl.

* * *

>go east
Market Square
The market is winding down for the evening. Stall holders roll up their cloth and argue over the day's takings. At the far end, a barber is still open, with his red and white pole catching the last of the light. On the opposite side, a merchant with silver streaked hair sits at a tavern table with a cup that never seems to empty.

The Barber is a thin and a fidgety man with nimble fingers and has restless eyes. He has the barber's habit of talking to fill silence, or to play the role of an unsolicited therapist. You can try and ask him about the proclamation.

The merchant is a broad, well dressed man who seems entirely too comfortable for someone living in a city with a monster problem. He has the look of a man who has learned that gold can buy distance from most troubles. You can try and ask him about the proclamation.

On the wall at the northern end of the market, near the palace gate, someone has scratched a crude calendar into the stone. Fourteen years worth of marks, each month noted. And beside the seventh year, a different mark, a rough shape like a curled, sleeping figure, and beside it an arrow pointing east. Toward the palace.

>examine wall
Someone kept a record. The marks for the first seven years are faint. The marks after are deep, frantic, the scratching of a person who needed to remember. The curled figure and the eastern arrow are the last entry. No more marks after that.

You trace the marks with a finger. Seven years of nothing. Then the creature woke. The shape beside the seventh year mark, curled, like something sleeping. It rested in the crypt for seven years before it stirred. And the arrow east. Toward the palace. Toward the vaults below it.

You already know where you must go.

>go east
The palace gate stands closed. The guards notices you. "Hey you!" but you notice also that they are nervous or almost terrified. For sure they don't want to be there. They notice the two swords and say, "Oh... haha, well you are witcher aint you? We can let you pass but we will not check on you!" You go through without a word.

Inside the courtyard, the silence hits you first. No insects. No birds. Nothing wants to be near this place after dark. Maybe you should prepare before going further.

Ruined Courtyard
The palace courtyard is a ruin. Weeds push through the paving. A fountain has long since gone dry, its basin full of dead leaves. The main doors of the palace hang open and they have not been properly closed in years. The windows above are dark. Something has broken most of them from the inside. It is very quiet. The main hall waits ahead.

There is a stone fountain, ornate once, now cracked and dry. The basin is filled with old leaves and what might be old bloodstains, gone brown.

The upper windows of the palace are all broken, most from the inside, and shards of old glass lie on the ledges and the courtyard below.

* * *

>go north
You can't go that way.

>go east
Eastern Chamber
You cannot see. The room is cold. The floor under your boots has changed from bare stone to something that crunches faintly... old debris, small bones perhaps. The air in here is different from the corridor, enclosed... Something large at the centre of the room, something your outstretched hand finds at shoulder height. Stone, cold, rough-edged. A box. Very large. Very old.

Something inside the stone box breathes. You freeze. It has not heard you. Or it does not care.She is in here. You can hear her. A low sound, not quite animal, closer to something in pain. Movement near the large stone object at the room's centre. She is not attacking. Not yet.

Your hands find the object again. It is a stone box. Large enough for a person. Something has scored the edges deeply. you feel the grooves under your fingers, long and parallel, like claw marks. Or fingernails.

>go west
Palace Vaults
The stairs end in darkness. Absolute darkness. You stop on the bottom step and hold still, letting your other senses work. The air is cold. Old. A smell like stone and something that has been alive a long time in a confined space. The floor is grit and old dust beneath your boots. You can hear the shape of the vault in the way sound does not travel. You cannot see. You move carefully.

You hear her. Close. A sound between breathing and growling, just ahead in the dark. You cannot tell exactly where.

Something moves in the dark ahead of you. The slow breathing stops. Stone grinds on stone. Then there is a sound you have no name for, and the air moves, and something is in the corridor with you.

>stand
But you aren't in anything at the moment.

>wait
Time passes.

>fight
What do you want to fight?

>go east
Eastern Chamber
You cannot see. The room is cold. The floor under your boots has changed from bare stone to something that crunches faintly... old debris, small bones perhaps. The air in here is different from the corridor, enclosed... Something large at the centre of the room, something your outstretched hand finds at shoulder height. Stone, cold, rough-edged. A box. Very large. Very old.

Something inside the stone box breathes. You freeze. It has not heard you. Or it does not care.She is in here. You can hear her. A low sound, not quite animal, closer to something in pain. Movement near the large stone object at the room's centre. She is not attacking. Not yet.

Your hands find the object again. It is a stone box. Large enough for a person. Something has scored the edges deeply. you feel the grooves under your fingers, long and parallel, like claw marks. Or fingernails.

>go west
Palace Vaults
The stairs end in darkness. Absolute darkness. You stop on the bottom step and hold still, letting your other senses work. The air is cold. Old. A smell like stone and something that has been alive a long time in a confined space. The floor is grit and old dust beneath your boots. You can hear the shape of the vault in the way sound does not travel. You cannot see. You move carefully.

You hear her. Close. A sound between breathing and growling, just ahead in the dark. You cannot tell exactly where.

>go east
Eastern Chamber
You cannot see. The room is cold. The floor under your boots has changed from bare stone to something that crunches faintly... old debris, small bones perhaps. The air in here is different from the corridor, enclosed... Something large at the centre of the room, something your outstretched hand finds at shoulder height. Stone, cold, rough-edged. A box. Very large. Very old.

Something inside the stone box breathes. You freeze. It has not heard you. Or it does not care.She is in here. You can hear her. A low sound, not quite animal, closer to something in pain. Movement near the large stone object at the room's centre. She is not attacking. Not yet.

Your hands find the object again. It is a stone box. Large enough for a person. Something has scored the edges deeply. you feel the grooves under your fingers, long and parallel, like claw marks. Or fingernails.

* * *

>see it
You read the proclamation carefully:

"BY ORDER OF KING FOLTEST OF TEMERIA

Let it be known to all citizens of Wyzim and its surroundings:

The palace district is hereby forbidden to all persons, by penalty of death. None shall enter, none shall linger after dark.

A creature of unknown nature dwells within the old palace vaults. It is dangerous. It kills. Fourteen years have passed since the curse was laid and seven since it first stirred.

His Majesty King Foltest, in his mercy, forbids any attempt upon the creature's life.

His Majesty hereby calls upon any man of skill and knowledge, witcher, sorcerer, or wise man, who believes themselves capable of lifting the curse upon the creature, to present themselves before the castellan Velerad at Wyzim.

Any man or woman capable of lifting the curse without harm to the creature shall be rewarded handsomely by the crown with three thousand oren.

Those who attempt to destroy the creature instead of breaking the spell will be tried for treason."

* * *

>ask about the proclamation
One of them spits on the floor near your boot. They are not interested in conversation.

Before you can press further, you feel hands on your shoulders. A moment later you are back outside, blinking in the sunlight.

Crossroads
You stand in front of the Old Narakort Inn, facing north. You spend a few seconds looking at the entrance, listening to the hubbub of voices. The Inn is full of people who may get the wrong impression of you. Farther down the street there is a smaller inn named The Fox, facing south. It is quite empty. You think about a contract you could make and a place to sleep when the night falls. Maybe a quiet place is a good option.

>go north
You push the door open and step inside.

Old Narakort Inn
You step inside. The smell of ale and sweat hits you first. The room is loud and packed. Farmers, merchants, a few armed men. The conversation dies the moment you cross the threshold. Every pair of eyes is on you. On your swords... On your eyes... Someone mutters something. Then another voice, louder: "We don't want your kind here, witcher."

You can drink, wait for something, even move, stay put or maybe ask them about the lether you found outside.. You think about leaving so you don't get into a fight for nothing.

A group of men sit hunched over their tankards, watching you with open hostility.

>ask them about it
The same man who spat on the floor stands up and yells, "You witchers are all the same... Fucking freaks.". Before you can move, the man invites you to leave, with a knife held in his hands. Then, you feel two hands on your shoulders. A moment later you are back outside, blinking in the sunlight.

Crossroads
You stand in front of the Old Narakort Inn, facing north. You spend a few seconds looking at the entrance, listening to the hubbub of voices. The Inn is full of people who may get the wrong impression of you. Farther down the street there is a smaller inn named The Fox, facing south. It is quite empty. You think about a contract you could make and a place to sleep when the night falls. Maybe a quiet place is a good option.

* * *

>pull it off
I only understood you as far as wanting to pull the Wad of White Goat Leather.

>pull it
You pull the leather off the wood, roll it up and tuck it into your jerkin. This certainly will be useful later.

* * *

>go south
You push open the door of The Fox. The hinges creak. Inside, it is dim and quiet. Just the way you like it.

Fox Inn
The Fox is quiet. A few candles burn low on the tables. The innkeeper glances up at you without alarm. He has seen worse, or at least pretends he has. This will do. The innkeeper eyes the hilt of your sword and then your face. He opens his mouth, thinks better of it, closes it again. He looks like a man with something heavy on his chest.

The innkeeper is a broad-shouldered man with a trimmed grey beard and careful eyes. He keeps his hands on the bar, easy and visible. You can ask for a room to stay the night.  Or you could ask about the proclamation...

>ask the innkeeper about the proclamation
The innkeeper studies you a moment, then sets down the rag he was using to wipe the bar. "You're a witcher, aren't you?" He does not wait for an answer. "I can always tell. The eyes... You... That white hair. Also the medallion. A wolf... from Kaer Mor... Something like that. You know, one called Vesemir had hair almost like yours. Maybe I should not ask about it. A lot of witchers pass here and some talk and I listen." He pours a cup of something dark and slides it across the counter without being asked. "I'll not throw you out," he says. "A man's coin is a man's coin. But..." He hesitates. "Have you seen the proclamation?"

He glances toward the door before he speaks again. You think on asking about the proclamation...
The innkeeper lowers his voice. "The proclamation on the gate. I expect you read it." He glances around the empty room, habit more than caution. "Fourteen years ago a curse fell on the old palace. The creature that lives in the vaults... folks say it is a terrible monster. A cursed thing, half woman, half beast. Kills without reason. Velerad, the king's castellan, he is the one offering the contract. His office is in the castle keep, north through the market. This market is not far from my inn. You should get there easily by just going east from here."

He refills your cup."I'll give you a room, witcher. Cheapest in Wyzim. Consider it goodwill. We could use someone who isn't afraid of that thing." He slides a key across the worn wood of the bar. You scoop it up, feeling the cold iron against your palm, and secure it in your pocket.

>examine it
You see nothing unexpected in that direction.

>examine key
A heavy iron key. The innkeeper gave it to you as goodwill, though you suspect he just wants the monster gone.

>inventory
You are carrying:
  a Room Key
  a Wad of White Goat Leather
  a Silver Sword
  an Iron Sword

>examine silver sword
Silver-bladed, witcher-made. Effective against cursed things, spirits, and creatures of magical origin.

>go east
Market Square
The market is winding down for the evening. Stall-holders roll up their cloth and argue over the day's takings. At the far end, a barber is still open, his red-and-white pole catching the last of the light. On the opposite side, a merchant with silver-streaked hair sits at a tavern table with a cup that never seems to empty.

The Barber is thin and a fidgety man with nimble fingers and restless eyes. He has the barber's habit of talking to fill silence, or to play the role of an unsolicited therapist. You can try and ask him about the proclamation.

The merchant is a broad, well-dressed man who seems entirely too comfortable for someone living in a city with a monster problem. He has the look of a man who has learned that gold can buy distance from most troubles. You can try and aks him about the proclamation.

On the wall at the northern end of the market, near the palace gate, someone has scratched a crude calendar into the stone. Fourteen years worth of marks, each month noted. And beside the seventh year, a different mark, a rough shape like a curled, sleeping figure, and beside it an arrow pointing east. Toward the palace.

>examine barber
He sharpens a razor on a leather strap, though he keeps glancing toward the north, toward the palace district.

>examine merchant
He wears good cloth and a careful smile. His eyes, though, move constantly. The kind of man who always knows where the nearest exit is.

>examine wall
Someone kept a record. The marks for the first seven years are faint. The marks after are deep, frantic, the scratching of a person who needed to remember. The curled figure and the eastern arrow are the last entry. No more marks after that.

You trace the marks with a finger. Seven years of nothing. Then the creature woke. The shape beside the seventh year mark, curled, like something sleeping. It rested in the crypt for seven years before it stirred. And the arrow east. Toward the palace. Toward the vaults below it.

You already know where you must go.

>ask Barber about the proclamation
The barber sets his razor down and leans forward. "You're here about the monster, aren't you? I can always tell. The eyes. And the swords, obviously." He lowers his voice to a theatrical whisper. "I'll tell you something no one else will. The creature... it was a child once. The king's daughter. Born of a cursed union, they say. The queen died in childbirth, and on that same night, the wise woman who came to deliver the girl laid a curse on her. Said she would not rest easy in death."

He picks up his razor again, examining the edge.

"Seven years she lay quiet in the crypt below the palace. Then she woke. Wrong. Not herself. Not human." He draws a finger across his throat. "They sealed the palace after that. But she gets out sometimes. Into the district. People die."

>ask Barber about something
"A cursed king's daughter," the barber repeats, clearly pleased to say it again. "That's what's in the palace vaults. The crypt is below the old throne room. That is all I know, witcher. The rest is your business."

>ask merchant about the proclamation
The merchant looks you over with frank appraisal. "Silk," he says, offering his name like a coin. "I trade in fine goods. Or I did, before the palace business made this city a destination for the morbid and the desperate." He swirls his cup.

"You want to know about the monster. Everyone does." He leans back. "I was here when it first stirred. Seven years after the birth, as they say. I lost two good warehouse men that year. The thing comes out at night, crosses the district... But here is what I know that the others don't. It always returns before dawn. Always. Back to the crypt. Back to where it came from. I've watched."

He finishes his drink.

"I do not know why, but it returns every time, before the cock crows."

>ask merchant about the proclamation
"It always returns before dawn," Silk repeats. "Back to the crypt. I do not know what that tells you, witcher, but I suspect you do."

>go north
Castle Keep
The castle is old and smells of damp stone and old candles. Guards eye you at the gate but let you pass. They know the look of someone who has come about the contract. Inside, the keep is dim, the tapestries faded. Velerad's office is at the end of the main corridor.

Velerad is a heavyset man in his fifties with a soldier's posture and a bureaucrat's tired eyes. He sits behind a broad desk covered in papers.

A rolled map of the palace district lies on the corner of Velerad's desk.

A stiff parchment with Velerad's seal and the terms of the commission.

* * *

>examine map
Velerad is not that happy. Is face is turning red. Maybe you should stop looking at his stuff before talking to him.

>examine contract
Velerad is like: "This piece of sh**"... Maybe you should ask him about the proclamation first before signing the contract.

>examine contract
Velerad is like: "This piece of sh**"... Maybe you should ask him about the proclamation first before signing the contract.

>sign contract
Velerad is like: "This piece of sh**"... Maybe you should ask him about the proclamation first before signing the contract.

>ask Velerad about the proclamation
Velerad watches your wandering eyes with theatrical exhaustion. "Tell me, do you usually paw, sniff, and salivate over a man's property before introducing yourself? Or is the olfactory inspection of my desk part of some secret Witcher ritual? Ahhh... Well..."

Velerad sets down his quill. "That medallion... A witcher. Good. Sit down." He does not wait to see if you will. "I am going to tell you everything, because the men I sent before you all died, and I am tired of burying good soldiers over a thing that might be fixed." He folds his hands.

"The creature is the king's daughter. Adda. Born under a curse laid by a wise woman at the birth. The circumstances I will not go into, they are... unpleasant, and irrelevant. For seven years she lay in the crypt below the palace, still. We thought the curse had come to nothing. Then she woke."

He stands and moves to a cabinet, pulling out a rolled map, which he sets flat on the desk. "The palace vaults below the old throne room. She lives there. The crypt has a sarcophagus, where she sleeps by day. At night she hunts. The king will not allow her to be killed. Because she is his daughter. He believes the curse can be broken and I am... less certain. But those are my orders, and so I am offering three thousand oren to anyone who can lift it."

He slides a document across the desk. It is the map that you already saw.

"The crypt lies below the palace, through the old throne room, down one flight. The sarcophagus is in the eastern vault. You will need to go at night. The creature only emerges at night. Witcher, do you know how to break a striga's curse? Well good luck because I don't and don't care. To me this monster should be killed, and if it comes to that Witcher..." Velerad starts laughing. "If you must, kill it, but i can't help you if it comes to that.". 

You have many details on how the monster behaves, and maybe how to break the curse. "Just one more thing Witcher! Sign the contract before you leave and I will tell you something usefull! Or just leave if you don't like contracts..."

>examine map
It shows the palace grounds, the outer walls, the main hall, and, marked in a different ink, a passage down to the vaults and a chamber marked "E. Vault" with a small drawing of a sarcophagus.

The route is clear enough. Through the palace gate, across the ruined courtyard, through the main hall, and down the stairs at the back. The eastern vault is the last chamber. You note the narrow staircase and the tight corridors. Not ideal for swordwork. You will need to be careful.

>examine Contract
Three thousand oren for breaking the curse on the creature known as Adda, the king's daughter. Penalty clauses for destroying the creature rather than freeing it. The king's seal at the bottom. All very official.

>sign contract
You sign your mark at the bottom of the contract. Velerad passes the ink and nods. "Good. The palace gate will be unlocked for you tonight. Do not go in before dark. The guards have orders to let no one through during the day. The creature sleeps, and we want it to stay that way until you are ready. One more thing. There is a herbalist on the south side of the market. She may have something useful for you." He writes a name on a slip of paper and hands it to you. "Mention my name."

>go south
Market Square
The market is winding down for the evening. Stall-holders roll up their cloth and argue over the day's takings. At the far end, a barber is still open, his red-and-white pole catching the last of the light. On the opposite side, a merchant with silver-streaked hair sits at a tavern table with a cup that never seems to empty.

The Barber is thin and a fidgety man with nimble fingers and restless eyes. He has the barber's habit of talking to fill silence, or to play the role of an unsolicited therapist. 

The merchant is a broad, well-dressed man who seems entirely too comfortable for someone living in a city with a monster problem. He has the look of a man who has learned that gold can buy distance from most troubles. 

On the wall at the northern end of the market, near the palace gate, someone has scratched a crude calendar into the stone. Fourteen years worth of marks, each month noted. And beside the seventh year, a different mark, a rough shape like a curled, sleeping figure, and beside it an arrow pointing east. Toward the palace.

>go south
Herbalist's Shop
A low building that smells of dried things like herbs, roots, something sharper beneath. Bundles of plants hang from every rafter.

The herbalist is a small woman of indeterminate age. Her hands are stained with various dyes and preparations, and she does not look up from her work when you enter. You should ask her about the monster.

There is a black potion here. Small dark vial stoppered with wax. It smells faintly of something rotten.

There is another potion in small amber vial. It smells sharp and clean.

* * *

>examine black potion
Maybe you should ask the herbalist about the monster first... No?

>take black potion
The herbalist raises her head. "Why don't you talk to me first before start taking my stuff?" You know that you are being stupid... This is not your way of doing things...

>ask herbalist about the monster in the palace
She looks up at last.

"Velerad's witcher.". She says it flatly. "I know what you need. A Black Blood potion. Toxic to things that feed on human blood. They bite the drinker, they suffer for it.". She sets a small dark vial on the counter. "And Cat. For the dark. The palace vaults have no lanterns.". She adds a second vial, this one amber. You know the last one off course... The Black Blood is important, if the striga bites you, the poison passes to it. Slows it. It will not kill the creature, but it will weaken it." She names a price. It is not unreasonable. "Take both," she says. "Come back alive so I know if they worked."

>examine black potion
A preparation toxic to creatures that feed on human blood. If they bite you while it is in your system, the poison transfers. The herbalist said it would weaken the striga, not kill it. That is exactly what you want.

>examine cat
A witcher's preparation that enhances sight in darkness. It is surprising that this herbalist sells this.

>take black potion
You already have that.

>take cat potion
You pocket the Cat potion. You will drink it before you go in.

>inventory
You are carrying:
  a Cat Potion
  a Black Blood Potion
  a Room Key
  a Wad of White Goat Leather
  a Silver Sword
  an Iron Sword

>go north
Market Square
The market is winding down for the evening. Stall-holders roll up their cloth and argue over the day's takings. At the far end, a barber is still open, his red-and-white pole catching the last of the light. On the opposite side, a merchant with silver-streaked hair sits at a tavern table with a cup that never seems to empty.

The Barber is thin and a fidgety man with nimble fingers and restless eyes. He has the barber's habit of talking to fill silence, or to play the role of an unsolicited therapist. 

The merchant is a broad, well-dressed man who seems entirely too comfortable for someone living in a city with a monster problem. He has the look of a man who has learned that gold can buy distance from most troubles. 

On the wall at the northern end of the market, near the palace gate, someone has scratched a crude calendar into the stone. Fourteen years worth of marks, each month noted. And beside the seventh year, a different mark, a rough shape like a curled, sleeping figure, and beside it an arrow pointing east. Toward the palace.

>go east
The palace gate stands open, as Velerad promised. The guards watch you go through without a word. One of them makes a sign against evil behind your back. You do not turn around.

Inside the courtyard, the silence hits you first. No insects. No birds. Nothing wants to be near this place after dark. Maybe you should prepare...

Ruined Courtyard
The palace courtyard is a ruin. Weeds push through the paving. A fountain has long since gone dry, its basin full of dead leaves. The main doors of the palace hang open and they have not been properly closed in years. The windows above are dark. Something has broken most of them from the inside. It is very quiet. The main hall waits ahead.

There is a stone fountain, ornate once, now cracked and dry. The basin is filled with old leaves and what might be old bloodstains, gone brown.

The upper windows of the palace are all broken, most from the inside, and shards of old glass lie on the ledges and the courtyard below.

>examine stone fountain
You can't see any such thing.

>examine fountain
The stains are old. Several years, at least. Whatever made them was dragged here from the direction of the main gate and left. An animal, perhaps.

>examine upper windows
You can't see any such thing.

>examine windows
Something large broke out of the upper floor. Or tried to. Many of the frames are scored with deep scratch marks. You note them and move on.

>examine palace courtyard
You can't see any such thing.

>go north
Old Palace Hall
The main hall is vast and hollow. Moonlight falls through the broken roof in pale columns, lighting nothing useful. Dust on the floor, disturbed in a path that leads from the far end of the hall, from the direction of the stairs going down, and across to the main doors. The path of something that moves on all fours, and then on two legs, and then on all fours again. The stairs to the vault are at the far end, going down. It is quiet. She is still below.

There is a trail worn into the dust of the floor, leading from the vault stairs to the main doors.

>eat cat potion
You uncork the Cat potion and drink it in one swallow. Bitter as ash. For a moment the world dims, and then snaps back sharper than before. The dark is grey instead of black, shapes clear and distinct. You can see. Your cat eyes... are different.

>inventory
You are carrying:
  a Black Blood Potion
  a Room Key
  a Wad of White Goat Leather
  a Silver Sword
  an Iron Sword

>eat Cat Potion
You can't see any such thing.

>eat the Cat Potion
You can't see any such thing.

>drink Cat Potion
You can't see any such thing.

>examine it
You can't see 'it' (nothing) at the moment.

>examine trail
You crouch and study it. The prints shift between something like bare human feet and something not human at all, with long claw-raking marks. The creature walks upright sometimes. Not always. The trail is worn deep. She has made this journey many times.

You already knew what you were facing. But seeing the tracks makes it real in a different way. She was a child once. Whatever she is now, she was a child. You stand up and move toward the stairs.

>go down
Palace Vaults
The stairs end in darkness.  Luckly you drank the cat potion. This way you can see throug the dark. The vault is a long, low corridor with several chambers off it. The eastern chamber, where the sarcophagus is, lies ahead. The air is cold and smells of old stone and something else, something that is not quite rot and not quite animal.

It is quiet. She has not yet emerged from the sarcophagus.

* * *

>pull wad
Nothing obvious happens.

>see wad
You get closer and see that it is a proclamation, signed by Foltest, King of Temeria, Pontar and Mahakam... You might want to examine it further to read the details.

>pull wad
Nothing obvious happens.

>pull it
Nothing obvious happens.

* * *

>see it
You get closer and see that it is a proclamation, signed by Foltest, King of Temeria, Pontar and Mahakam... You might want to examine it further to read the details.

>ask about it
You can't see any such thing.

>see it
You read the proclamation carefully:

"BY ORDER OF KING FOLTEST OF TEMERIA

Let it be known to all citizens of Wyzim and its surroundings:

The palace district is hereby forbidden to all persons, by penalty of death. None shall enter, none shall linger after dark.

A creature of unknown nature dwells within the old palace vaults. It is dangerous. It kills. Fourteen years have passed since the curse was laid and seven since it first stirred.

His Majesty King Foltest, in his mercy, forbids any attempt upon the creature's life.

His Majesty hereby calls upon any man of skill and knowledge, witcher, sorcerer, or wise man, who believes themselves capable of lifting the curse upon the creature, to present themselves before the castellan Velerad at Wyzim.

Any man or woman capable of lifting the curse without harm to the creature shall be rewarded handsomely by the crown with three thousand oren.

Those who attempt to destroy the creature instead of breaking the spell will be tried for treason."

You think about pulling it off in case you need to ask about it.

>pull it
You pull the leather off the wood, roll it up and tuck it into your jerkin. This certainly will be useful later.

* * *

>ask about it
You can't see any such thing.

>ask innkeeper
The innkeeper studies you a moment, then sets down the rag he was using to wipe the bar.  "You're a witcher, aren't you?" He does not wait for an answer. "I can always tell. The eyes... You... That white hair. Also the medallion. A wolf... from Kaer Mor... Something like that. You know, one called Vesemir had hair almost like yours. Maybe I should not ask about it. A lot of witchers pass here and some talk and I listen." He pours a cup of something dark and slides it across the counter without being asked. "I'll not throw you out," he says. "A man's coin is a man's coin. But..." He hesitates. "Have you seen the proclamation?"

He glances toward the door before he speaks again.
The innkeeper lowers his voice. "The proclamation on the gate. I expect you read it." He glances around the empty room, habit more than caution. "Fourteen years ago a curse fell on the old palace. The creature that lives in the vaults... folks say it is a terrible monster. A cursed thing, half woman, half beast. Kills without reason. Velerad, the king's castellan, he is the one offering the contract. His office is in the castle keep, north through the market. This market is not far from my inn. You should get there easily by just going east from here."

He refills your cup."I'll give you a room, witcher. Cheapest in Wyzim. Consider it goodwill. We could use someone who isn't afraid of that thing." He slides a key across the worn wood of the bar. You scoop it up, feeling the cold iron against your palm, and secure it in your pocket.

>go east
Market Square
The market is winding down for the evening. Stall holders roll up their cloth and argue over the day's takings. At the far end, a barber is still open, with his red and white pole catching the last of the light. On the opposite side, a merchant with silver streaked hair sits at a tavern table with a cup that never seems to empty.

The Barber is a thin and a fidgety man with nimble fingers and has restless eyes. He has the barber's habit of talking to fill silence, or to play the role of an unsolicited therapist. You can try and ask him about the proclamation.

The merchant is a broad, well dressed man who seems entirely too comfortable for someone living in a city with a monster problem. He has the look of a man who has learned that gold can buy distance from most troubles. You can try and ask him about the proclamation.

On the wall at the northern end of the market, near the palace gate, someone has scratched a crude calendar into the stone. Fourteen years worth of marks, each month noted. And beside the seventh year, a different mark, a rough shape like a curled, sleeping figure, and beside it an arrow pointing east. Toward the palace.

>ask barber
The barber sets his razor down and leans forward. "You're here about the monster, aren't you? I can always tell. The eyes. And the swords, obviously." He lowers his voice to a theatrical whisper. "I'll tell you something no one else will. The creature... it was a child once. The king's daughter. Born of a cursed union, they say. The queen died in childbirth, and on that same night, the wise woman who came to deliver the girl laid a curse on her. Said she would not rest easy in death."

He picks up his razor again, examining the edge.

"Seven years she lay quiet in the crypt below the palace. Then she woke. Not herself. Not human." He draws a finger across his throat. "They sealed the palace after that. But she gets out sometimes. Into the district. People die."

>ask barber about it
There is no reply.

>ask barber
"A cursed king's daughter," the barber repeats, clearly pleased to say it again. "That's what's in the palace vaults. The crypt is below the old throne room. That is all I know, witcher. The rest is your business."

* * *

>see it
You get closer and see that it is a proclamation, signed by Foltest, King of Temeria, Pontar and Mahakam... You might want to examine it further to read the details.

>see it
You read the proclamation carefully:

"BY ORDER OF KING FOLTEST OF TEMERIA

Let it be known to all citizens of Wyzim and its surroundings:

The palace district is hereby forbidden to all persons, by penalty of death. None shall enter, none shall linger after dark.

A creature of unknown nature dwells within the old palace vaults. It is dangerous. It kills. Fourteen years have passed since the curse was laid and seven since it first stirred.

His Majesty King Foltest, in his mercy, forbids any attempt upon the creature's life.

His Majesty hereby calls upon any man of skill and knowledge, witcher, sorcerer, or wise man, who believes themselves capable of lifting the curse upon the creature, to present themselves before the castellan Velerad at Wyzim.

Any man or woman capable of lifting the curse without harm to the creature shall be rewarded handsomely by the crown with three thousand oren.

Those who attempt to destroy the creature instead of breaking the spell will be tried for treason."

You think about pulling it off in case you need to ask about it.

* * *

>pull it
You pull the leather off the wood, roll it up and tuck it into your jerkin. This certainly will be useful later.

>go north
You push the door open and step inside.

Old Narakort Inn
You step inside. The smell of ale and sweat hits you first. The room is loud and packed. Farmers, merchants, a few armed men. The conversation dies the moment you cross the threshold. Every pair of eyes is on you. On your swords... On your eyes... Someone mutters something. Then another voice, louder: "We don't want your kind here, witcher."

You can drink, wait for something, even move, stay put or maybe ask them about the lether you found outside.. You think about leaving so you don't get into a fight for nothing.

A group of men sit hunched over their tankards, watching you with open hostility.

>ask about the lether
You can't see any such thing.

* * *

>ask the lether
One of them spits on the floor near your boot. They are not interested in conversation.

Before you can press further, you feel hands on your shoulders. A moment later you are back outside, blinking in the sunlight.

Crossroads
You stand in front of the Old Narakort Inn, facing north. You spend a few seconds looking at the entrance, listening to the hubbub of voices. The Inn is full of people who may get the wrong impression of you. Farther down the street there is a smaller inn named The Fox, facing south. It is quite empty. You think about a contract you could make and a place to sleep when the night falls. Maybe a quiet place is a good option.

>go south
You push open the door of The Fox. The hinges creak. Inside, it is dim and quiet. Just the way you like it.

Fox Inn
The Fox is quiet. A few candles burn low on the tables. The innkeeper glances up at you without alarm. He has seen worse, or at least pretends he has. This will do. The innkeeper eyes the hilt of your sword and then your face. He opens his mouth, thinks better of it, closes it again. He looks like a man with something heavy on his chest.

The innkeeper is a broad-shouldered man with a trimmed grey beard and careful eyes. He keeps his hands on the bar, easy and visible. You can ask for a room to stay the night.  Or you could ask about the proclamation...

>ask about the proclamation
The innkeeper studies you a moment, then sets down the rag he was using to wipe the bar. "You have a desire to die I guess... Going to a place like Narakort.". He pauses.
 "You're a witcher, aren't you?" He does not wait for an answer. "I can always tell. The eyes... You... That white hair. Also the medallion. A wolf... from Kaer Mor... Something like that. You know, one called Vesemir had hair almost like yours. Maybe I should not ask about it. A lot of witchers pass here and some talk and I listen." He pours a cup of something dark and slides it across the counter without being asked. "I'll not throw you out," he says. "A man's coin is a man's coin. But..." He hesitates. "Have you seen the proclamation?"

He glances toward the door before he speaks again.
The innkeeper lowers his voice. "The proclamation on the gate. I expect you read it." He glances around the empty room, habit more than caution. "Fourteen years ago a curse fell on the old palace. The creature that lives in the vaults... folks say it is a terrible monster. A cursed thing, half woman, half beast. Kills without reason. Velerad, the king's castellan, he is the one offering the contract. His office is in the castle keep, north through the market. This market is not far from my inn. You should get there easily by just going east from here."

He refills your cup."I'll give you a room, witcher. Cheapest in Wyzim. Consider it goodwill. We could use someone who isn't afraid of that thing." He slides a key across the worn wood of the bar. You scoop it up, feeling the cold iron against your palm, and secure it in your pocket.

>go east
Market Square
The market is winding down for the evening. Stall holders roll up their cloth and argue over the day's takings. At the far end, a barber is still open, with his red and white pole catching the last of the light. On the opposite side, a merchant with silver streaked hair sits at a tavern table with a cup that never seems to empty.

The Barber is a thin and a fidgety man with nimble fingers and has restless eyes. He has the barber's habit of talking to fill silence, or to play the role of an unsolicited therapist. You can try and ask him about the proclamation.

The merchant is a broad, well dressed man who seems entirely too comfortable for someone living in a city with a monster problem. He has the look of a man who has learned that gold can buy distance from most troubles. You can try and ask him about the proclamation.

On the wall at the northern end of the market, near the palace gate, someone has scratched a crude calendar into the stone. Fourteen years worth of marks, each month noted. And beside the seventh year, a different mark, a rough shape like a curled, sleeping figure, and beside it an arrow pointing east. Toward the palace.

>ask barber about the lether
The barber sets his razor down and leans forward. "You're here about the monster, aren't you? I can always tell. The eyes. And the swords, obviously." He lowers his voice to a theatrical whisper. "I'll tell you something no one else will. The creature... it was a child once. The king's daughter. Born of a cursed union, they say. The queen died in childbirth, and on that same night, the wise woman who came to deliver the girl laid a curse on her. Said she would not rest easy in death."

He picks up his razor again, examining the edge.

"Seven years she lay quiet in the crypt below the palace. Then she woke. Not herself. Not human." He draws a finger across his throat. "They sealed the palace after that. But she gets out sometimes. Into the district. People die."

* * *

>ask merchant about the lether
The merchant looks you over with frank appraisal. "Silk," he says, offering his name like a coin. "I trade in fine goods. Or I did, before the palace business made this city a destination for the morbid and the desperate." He swirls his cup.

"You want to know about the monster. Everyone does." He leans back. "I was here when it first stirred. Seven years after the birth, as they say. I lost two good warehouse men that year. The thing comes out at night, crosses the district... But here is what I know that the others don't. It always returns before dawn. Always. Back to the crypt. Back to where it came from. I've watched."

He finishes his drink.

"I do not know why, but it returns every time, before the cock crows."

* * *

>pull it
You pull the leather off the wood, roll it up and tuck it into your jerkin. This certainly will be useful later.

>go outh
You can't see any such thing.

>go south
You push open the door of The Fox. The hinges creak. Inside, it is dim and quiet. Just the way you like it.

Fox Inn
The Fox is quiet. A few candles burn low on the tables. The innkeeper glances up at you without alarm. He has seen worse, or at least pretends he has. This will do. The innkeeper eyes the hilt of your sword and then your face. He opens his mouth, thinks better of it, closes it again. He looks like a man with something heavy on his chest.

The innkeeper is a broad-shouldered man with a trimmed grey beard and careful eyes. He keeps his hands on the bar, easy and visible. You can ask for a room to stay the night.  Or you could ask about the proclamation...

* * *

>go north
Castle Keep
The castle is old and smells of damp stone and old candles. Guards eye you at the gate but let you pass. They know the look of someone who has come about the contract. Inside, the keep is dim, the tapestries faded. Velerad's office is at the end of the main corridor.

Velerad is a heavyset man in his fifties with a soldier's posture and a bureaucrat's tired eyes. He sits behind a broad desk covered in papers.

A rolled map of the palace district lies on the corner of Velerad's desk.

A stiff parchment with Velerad's seal and the terms of the commission.

>ask Velerad about the p
Velerad sets down his quill. "That medallion... A witcher. Good. Sit down." He does not wait to see if you will. "I am going to tell you everything, because the men I sent before you all died, and I am tired of burying good soldiers over a thing that might be fixed." He folds his hands.

"The creature is the king's daughter. Adda. Born under a curse laid by a wise woman at the birth. The circumstances I will not go into, they are... unpleasant, and irrelevant. For seven years she lay in the crypt below the palace, still. We thought the curse had come to nothing. Then she woke."

He stands and moves to a cabinet, pulling out a rolled map, which he sets flat on the desk. "The palace vaults below the old throne room. She lives there. The crypt has a sarcophagus, where she sleeps by day. At night she hunts. The king will not allow her to be killed, because she is his daughter. He believes the curse can be broken and I am... less certain. But those are my orders, and so I am offering three thousand oren to anyone who can lift it. A crazy old man once said that someone must spend the night with the thing until the cock crows for the third time. You should see what remains of him..." Velerad laughs. You know the old man was likely right. You've heard of this before. It is no wonder he died, however, as a striga is a formidable monster, even witchers struggle against one.

Velerad slides a document across the desk. It is a map. You should examine further.

"The crypt lies below the palace, through the old throne room, down one flight. The sarcophagus is in the eastern vault. You will need to go at night. The creature only emerges at night. Witcher, do you know how to break a striga's curse? Well good luck because I don't and don't care. To me this monster should be killed, and if it comes to that Witcher..." Velerad starts laughing. "If you must, kill it, but i can't help you if it comes to that.". 

You have many details on how the monster behaves, and maybe how to break the curse. "Just one more thing Witcher! Sign the contract before you leave and I will tell you something usefull! Or just leave if you don't like contracts..."

>sign it
You sign your mark at the bottom of the contract. Velerad passes the ink and nods. "Good. The palace gate will be unlocked for you tonight. Do not go in before dark. The guards have orders to let no one through during the day. The creature sleeps, and we want it to stay that way until you are ready. One more thing. There is a herbalist on the south side of the market. She may have something useful for you." He writes a name on a slip of paper and hands it to you. "Mention my name."

>go south
Market Square
The market is winding down for the evening. Stall holders roll up their cloth and argue over the day's takings. At the far end, a barber is still open, with his red and white pole catching the last of the light. On the opposite side, a merchant with silver streaked hair sits at a tavern table with a cup that never seems to empty.

The Barber is a thin and a fidgety man with nimble fingers and has restless eyes. He has the barber's habit of talking to fill silence, or to play the role of an unsolicited therapist. You can try and ask him about the proclamation.

The merchant is a broad, well dressed man who seems entirely too comfortable for someone living in a city with a monster problem. He has the look of a man who has learned that gold can buy distance from most troubles. You can try and ask him about the proclamation.

On the wall at the northern end of the market, near the palace gate, someone has scratched a crude calendar into the stone. Fourteen years worth of marks, each month noted. And beside the seventh year, a different mark, a rough shape like a curled, sleeping figure, and beside it an arrow pointing east. Toward the palace.

* * *

>go south
Herbalist's Shop
A low building that smells of dried things like herbs, roots, something sharper beneath. Bundles of plants hang from every rafter.

The herbalist is a small woman of indeterminate age. Her hands are stained with various dyes and preparations, and she does not look up from her work when you enter. You should ask her about the monster.

There is a black potion here. Small dark vial stoppered with wax. It smells faintly of something rotten.

There is another potion in small amber vial. It smells sharp and clean.

>ask her abot t
I didn't understand that sentence.

>ask her about it
She looks up at last.

"Velerad's witcher.". She says it flatly. "I know what you need. A Black Blood potion. Toxic to things that feed on human blood. They bite the drinker, they suffer for it.". She sets a small dark vial on the counter. "And Cat. For the dark. The palace vaults have no lanterns.". She adds a second vial, this one amber. You know the last one off course... The Black Blood is important, if the striga bites you, the poison passes to it. Slows it. It will not kill the creature, but it will weaken it." She names a price. It is not unreasonable. "Take both," she says. "Come back alive so I know if they worked.

 You should follow what she says. Take both potions and examine them."

* * *

>take both
Black Blood Potion: You pocket the Black Blood potion carefully.
Cat Potion: You pocket the Cat potion. You will drink it before you go in.

>inventory
You are carrying:
  a Cat Potion
  a Black Blood Potion
  a Room Key
  a Proclamation
  a Silver Sword
  an Iron Sword
  a Magical Signs Tome

>go south
You can't go that way.

>go north
Market Square
The market is winding down for the evening. Stall holders roll up their cloth and argue over the day's takings. At the far end, a barber is still open, with his red and white pole catching the last of the light. On the opposite side, a merchant with silver streaked hair sits at a tavern table with a cup that never seems to empty.

The Barber is a thin and a fidgety man with nimble fingers and has restless eyes. He has the barber's habit of talking to fill silence, or to play the role of an unsolicited therapist. You can try and ask him about the proclamation.

The merchant is a broad, well dressed man who seems entirely too comfortable for someone living in a city with a monster problem. He has the look of a man who has learned that gold can buy distance from most troubles. You can try and ask him about the proclamation.

On the wall at the northern end of the market, near the palace gate, someone has scratched a crude calendar into the stone. Fourteen years worth of marks, each month noted. And beside the seventh year, a different mark, a rough shape like a curled, sleeping figure, and beside it an arrow pointing east. Toward the palace.

* * *

>drink cat potion
You uncork the Cat potion and drink it in one swallow. Bitter as ash. For a moment the world dims, and then snaps back sharper than before. The dark is grey instead of black, shapes clear and distinct. You can see. Your cat eyes... are different.

Now you can see... The stairs end in grey half-light. The cat potion does its work. The vault is a long, low corridor with a stoned floor. Several chambers open off it. The eastern chamber lies at the far end. The air is cold and carries something that is not rot and not animal but is both and neither.

>go east
Eastern Chamber
A stone chamber. In the centre stands the sarcophagus, a heavy grey stone, its lid displaced, scored with deep claw marks along every edge. The smell is strong here. Old. Wrong.She is in here. You can hear her. A low sound, not quite animal, closer to something in pain. Movement near the large stone object at the room's centre. She is not attacking. Not yet.

 There is a heavy stone sarcophagus with its lid partially displaced. The stone around the edges is scored with claw marks, deep and repetitive, the work of years.

The sarcophagus. She is inside it. You can hear her breathing, slow and deep, through the gap in the lid.

You see the heavy lid of the sarcophagus begin to slide. A pale, clawed hand hooks over the edge, and with a sudden, violent burst of strength, she flings herself out. She crouches on the stone floor, her eyes reflecting the faint light, fixed entirely on you. You will need to fight it. Remember what you have!
 The black potion can weaken it, but you need let her attack you.

>drink black potion
You uncork the Black Blood potion and drink it in one swallow. It has no taste. Nothing. Then the cold sets in, spreading from your chest outward and slow. You look down at your arm and you see the veins beneath the skin are darker, nearly black. The potion is in you now. When she bites, she will taste it. You just need to let her get close enough. But that is only half the problem, you still need to find a way to last until dawn.

* * *

>ask about it
You can't see any such thing.

>ask him about it
The innkeeper studies you a moment, then sets down the rag he was using to wipe the bar.  "You're a witcher, aren't you?" He does not wait for an answer. "I can always tell. The eyes... You... That white hair. Also the medallion. A wolf... from Kaer Mor... Something like that. You know, one called Vesemir had hair almost like yours. Maybe I should not ask about it. A lot of witchers pass here and some talk and I listen." He pours a cup of something dark and slides it across the counter without being asked. "I'll not throw you out," he says. "A man's coin is a man's coin. But..." He hesitates. "Have you seen the proclamation?"

He glances toward the door before he speaks again.
The innkeeper lowers his voice. "The proclamation on the gate. I expect you read it." He glances around the empty room, habit more than caution. "Fourteen years ago a curse fell on the old palace. The creature that lives in the vaults... folks say it is a terrible monster. A cursed thing, half woman, half beast. Kills without reason. Velerad, the king's castellan, he is the one offering the contract. His office is in the castle keep, north through the market. This market is not far from my inn. You should get there easily by just going east from here."

He refills your cup."I'll give you a room, witcher. Cheapest in Wyzim. Consider it goodwill. We could use someone who isn't afraid of that thing." He slides a key across the worn wood of the bar. You scoop it up, feeling the cold iron against your palm, and secure it in your pocket.

* * *

>talk with barber
You can't see any such thing.

>talk to barber
The barber sets his razor down and leans forward. "You're here about the monster, aren't you? I can always tell. The eyes. And the swords, obviously." He lowers his voice to a theatrical whisper. "I'll tell you something no one else will. The creature... it was a child once. The king's daughter. Born of a cursed union, they say. The queen died in childbirth, and on that same night, the wise woman who came to deliver the girl laid a curse on her. Said she would not rest easy in death."

He picks up his razor again, examining the edge.

"Seven years she lay quiet in the crypt below the palace. Then she woke. Not herself. Not human." He draws a finger across his throat. "They sealed the palace after that. But she gets out sometimes. Into the district. People die."

>talk to barber
"A cursed king's daughter," the barber repeats, clearly pleased to say it again. "That's what's in the palace vaults. The crypt is below the old throne room. That is all I know, witcher. The rest is your business."

>talk to the merchant
The merchant looks you over with frank appraisal. "Silk," he says, offering his name like a coin. "I trade in fine goods. Or I did, before the palace business made this city a destination for the morbid and the desperate." He swirls his cup.

"You want to know about the monster. Everyone does." He leans back. "I was here when it first stirred. Seven years after the birth, as they say. I lost two good warehouse men that year. The thing comes out at night, crosses the district... But here is what I know that the others don't. It always returns before dawn. Always. Back to the crypt. Back to where it came from. I've watched."

He finishes his drink.

"I do not know why, but it returns every time, before the cock crows."

>talk to the merchant
"It always returns before dawn," Silk repeats. "Back to the crypt. I do not know what that tells you, witcher, but I suspect you do."

>see wall
Someone kept a record. The marks for the first seven years are faint. The marks after are deep, frantic, the scratching of a person who needed to remember. The curled figure and the eastern arrow are the last entry. No more marks after that.

You trace the marks with a finger. Seven years of nothing. Then the creature woke. The shape beside the seventh year mark, curled, like something sleeping. It rested in the crypt for seven years before it stirred. And the arrow east. Toward the palace. Toward the vaults below it.

You already know where you must go.

>go north
Castle Keep
The castle is old and smells of damp stone and old candles. Guards eye you at the gate but let you pass. They know the look of someone who has come about the contract. Inside, the keep is dim, the tapestries faded. Velerad's office is at the end of the main corridor.

Velerad is a heavyset man in his fifties with a soldier's posture and a bureaucrat's tired eyes. He sits behind a broad desk covered in papers. You should talk with him!

A rolled map of the palace district lies on the corner of Velerad's desk.

A stiff parchment with Velerad's seal and the terms of the commission.

>talk to velerad
Velerad sets down his quill. "That medallion... A witcher. Good. Sit down." He does not wait to see if you will. "I am going to tell you everything, because the men I sent before you all died, and I am tired of burying good soldiers over a thing that might be fixed." He folds his hands.

"The creature is the king's daughter. Adda. Born under a curse laid by a wise woman at the birth. The circumstances I will not go into, they are... unpleasant, and irrelevant. For seven years she lay in the crypt below the palace, still. We thought the curse had come to nothing. Then she woke."

He stands and moves to a cabinet, pulling out a rolled map, which he sets flat on the desk. "The palace vaults below the old throne room. She lives there. The crypt has a sarcophagus, where she sleeps by day. At night she hunts. The king will not allow her to be killed, because she is his daughter. He believes the curse can be broken and I am... less certain. But those are my orders, and so I am offering three thousand oren to anyone who can lift it. A crazy old man once said that someone must spend the night with the thing until the cock crows for the third time. You should see what remains of him..." Velerad laughs. You know the old man was likely right. You've heard of this before. It is no wonder he died, however, as a striga is a formidable monster, even witchers struggle against one.

Velerad slides a document across the desk. It is a map. You should examine further.

"The crypt lies below the palace, through the old throne room, down one flight. The sarcophagus is in the eastern vault. You will need to go at night. The creature only emerges at night. Witcher, do you know how to break a striga's curse? Well good luck because I don't and don't care. To me this monster should be killed, and if it comes to that Witcher..." Velerad starts laughing. "If you must, kill it, but i can't help you if it comes to that.". 

You have many details on how the monster behaves, and maybe how to break the curse. "Just one more thing Witcher! Sign the contract before you leave and I will tell you something usefull! Or just leave if you don't like contracts..."

>sign it
You sign your mark at the bottom of the contract. Velerad passes the ink and nods. "Good. The palace gate will be unlocked for you tonight. Do not go in before dark. The guards have orders to let no one through during the day. The creature sleeps, and we want it to stay that way until you are ready. One more thing. There is a herbalist on the south side of the market. She may have something useful for you." He writes a name on a slip of paper and hands it to you. "Mention my name."

>go north
You can't go that way.

* * *

>go south
Herbalist's Shop
A low building that smells of dried things like herbs, roots, something sharper beneath. Bundles of plants hang from every rafter.

The herbalist is a small woman of indeterminate age. Her hands are stained with various dyes and preparations, and she does not look up from her work when you enter. You should ask her about the monster.

There is a black potion here. Small dark vial stoppered with wax. It smells faintly of something rotten.

There is another potion in small amber vial. It smells sharp and clean.

>talk to her
She looks up at last.

"Velerad's witcher.". She says it flatly. "I know what you need. A Black Blood potion. Toxic to things that feed on human blood. They bite the drinker, they suffer for it.". She sets a small dark vial on the counter. "And Cat. For the dark. The palace vaults have no lanterns.". She adds a second vial, this one amber. You know the last one off course... The Black Blood is important, if the striga bites you, the poison passes to it. Slows it. It will not kill the creature, but it will weaken it." She names a price. It is not unreasonable. "Take both," she says. "Come back alive so I know if they worked.

 You should follow what she says. Take both potions and examine them."

>take both
Black Blood Potion: You pocket the Black Blood potion carefully.
Cat Potion: You pocket the Cat potion. You will drink it before you go in.

>go south
You can't go that way.

>go north
Market Square
The market is winding down for the evening. Stall holders roll up their cloth and argue over the day's takings. At the far end, a barber is still open, with his red and white pole catching the last of the light. On the opposite side, a merchant with silver streaked hair sits at a tavern table with a cup that never seems to empty.

The Barber is a thin and a fidgety man with nimble fingers and has restless eyes. He has the barber's habit of talking to fill silence, or to play the role of an unsolicited therapist. 

The merchant is a broad, well dressed man who seems entirely too comfortable for someone living in a city with a monster problem. He has the look of a man who has learned that gold can buy distance from most troubles. 

On the wall at the northern end of the market, near the palace gate, someone has scratched a crude calendar into the stone. Fourteen years worth of marks, each month noted. And beside the seventh year, a different mark, a rough shape like a curled, sleeping figure, and beside it an arrow pointing east. Toward the palace.

* * *

>go north
Old Palace Hall
The main hall is vast and hollow. Moonlight falls through the broken roof in pale columns, lighting nothing useful. Dust on the floor, disturbed in a path that leads from the far end of the hall, from the direction of the stairs going down, and across to the main doors. The path of something that moves on all fours, and then on two legs, and then on all fours again. The stairs to the vault are at the far end, going down. It is quiet. She is still below.

There is a trail worn into the dust of the floor, leading from the vault stairs to the main doors.

>examine trail
You crouch and study it. The prints shift between something like bare human feet and something not human at all, with long claw-raking marks. The creature walks upright sometimes. Not always. The trail is worn deep. She has made this journey many times.

You already knew what you were facing. But seeing the tracks makes it real in a different way. She was a child once. Whatever she is now, she was a child. You stand up and move toward the stairs.

>go down
Palace Vaults
The stairs end in darkness. Absolute darkness. You stop on the bottom step and hold still, letting your other senses work. The air is cold. Old. A smell like stone and something that has been alive a long time in a confined space. The floor is grit and old dust beneath your boots. You can hear the shape of the vault in the way sound does not travel. You cannot see. You move carefully.

Somewhere in your right, east, in the dark, something breathes very slowly.

* * *

>go east
Eastern Chamber
A stone chamber. In the centre stands the sarcophagus, a heavy grey stone, its lid displaced, scored with deep claw marks along every edge. The smell is strong here. Old. Wrong.She is in here. You can hear her. A low sound, not quite animal, closer to something in pain. Movement near the large stone object at the room's centre. She is not attacking. Not yet.

 There is a heavy stone sarcophagus with its lid partially displaced. The stone around the edges is scored with claw marks, deep and repetitive, the work of years.

You move toward the source of the sound. There she is, standing in the middle of the chamber. You cannot kill her. You need to weaken her somehow and survive the night with her until dawn. You will need to think of something clever or you will not last until dawn otherwise. Check your surroundings! Use your silver sword and signs.

>examine stone
You can't see any such thing.

>examine heavy stone
 

The sarcophagus sits at the far end of the chamber. Stone, old, the lid slightly askew. She has been moving it from the inside. The air around it is colder than the rest of the vault.

>examine heavy stone sarcophagus
 

The sarcophagus sits at the far end of the chamber. Stone, old, the lid slightly askew. She has been moving it from the inside. The air around it is colder than the rest of the vault.

>yrden sign
In a fight like this there is no room to inscribe the yrden sign on solid ground. SHe is too close to you. You need to drive her back first.

>igni
You cast Igni. Flames erupt from your fingers, and the stench of scorched flesh lingers in the air. She retreats a little, buying you a moment to think. You need to weaken her somehow.
Somehow you must survive until dawn with that beast. But how? Is there somewhere to hide? Somewhere you might use a sign to your advantage?
Your blood is darker now. You can feel it. Wait for her to come to you.

>wait
You steady yourself. You know you need to wait for her attack, but you cannot let her go for your throat or anywhere vital. She launches herself at you and you shift left at the last moment, leaving your arm in front of her mouth. She bites down. The pain is sharp and immediate, but your witcher training takes over, your body pushes it aside before your mind has time to register it.

She is slowing down. The Black Blood is working. This is your chance to finish her... But you will not receive the orens and you will be wanted by the crown of Foltest. You need to hide until dawn. Where can you go?

>hide in the box
In a flash, a thought cuts through the noise. The sarcophagus... it is open. You catch it from the corner of your eye. You run to it and climb in, pulling the lid over yourself. But it will not hold on its own. You need to keep her out somehow. Hold the lid? A sign, perhaps?

>inventory
You are carrying:
  a Room Key
  a Proclamation
  a Silver Sword
  an Iron Sword
  a Magical Signs Tome

>check magical signs tome
The basic five witcher signs: Aard, Igni, Yrden, Quen, and Axii. You can examine further each sign.

>check yrden
The Yrden sign when inscribed on a solid surface, it blocks the monsters from getting closer, scaring them off. If a hostile being enters the area affected by Sign, it is visibly slowed down, and non-corporeal forces become corporeal.

>attack it
Violence isn't the answer to this one.

* * *

>yrden
You lay your sword on your chest and raise one hand to the stone slab above you. In the dark of the sarcophagus you trace the Yrden sign on the inside of the lid. The lines settle into something you feel more than see... a faint warmth against cold stone, a stillness that seeps down through the slab. You should wait or brace yourself.

>brace
Inside the silence is complete. The sign on the lid hums faintly against your palm. Outside, there is still roars. She is angry... You lie still. Your sword rests on your chest. You breathe slowly and wait. The smell of stone. The smell of old death. The smell of something almost over.

Somewhere above, distant and uncertain, a cock calls once and falls silent.

>brace
She gives one final push, but this time something is wrong. The force behind it is less than it should be. Through the stone, you can feel it... she is slowing. The Yrden sign has done its work, sapping the violence from her and turning her strength into confusion. She presses against the lid once, twice, weakly, like a creature that has forgotten why it is fighting. Then, she stops. The pressure vanishes. You fall into a deep state of mind, almost meditating... You could get out now to see if the curse is lifted, or you could stay inside.

The cock crows for the second time...

>brace
You push the lid aside yourself and sit up. Dawn light fills the chamber... pale and clean, falling through a crack in the vault ceiling. It touches the floor. It touches her. She is on the floor beside the sarcophagus. A girl with fourteen years old, skin and bone, curled on the cold stone as though she had simply lain down to sleep. She is shaking.

Her eyes open. They are human eyes. She stares up at you, sitting upright in a sarcophagus with the sword still across your chest. Her mouth moves. No words come. She has not spoken in seven years. But the eyes are hers. Whatever lived behind them before is gone. You climb out and set her down more gently than your aching arms would prefer.

The curse is broken. You should carry the girl to the Palace Vaults.

>carry the girl
I don't suppose the creature would care for that.

>carry the girl to the Palace
Which do you mean, the Old Palace Hall or the Palace Vaults?

>carry the girl to the Palace Vaults
You carry the girl up to the main hall, then out through the palace doors into the courtyard. The morning air is cool and clean after the vaults. Velerad is already waiting at the gate. He did not sleep. He sees you, sees the girl, and his face does something complicated... relief and grief and something else.

"Is she..." he starts. "Alive," you say. "The curse is broken.". Velerad takes the girl from your arms carefully, as though she might shatter. She does not wake. She breathes. "The king will want to see her." His voice is rough. You accept the purse of coin he hands you. The contract is fulfilled.

"Witcher," Velerad says, as you turn to go. "Will she be... herself again?" You look at the girl in his arms. Fourteen years in a crypt. Seven of them not quite human. What comes back from that, you do not know. You have done what you were paid to do."She will be alive," you say. "That is the start."

You walk back through the market as the city wakes around you. Someone with sharp eyes recognizes what you are. No one says anything. Three thousand oren in your pocket. Your horse waiting at The Fox. Time to move on.

    *** The curse is lifted. Adda lives. You ride north. To your destiny. To the Law of Surprise... The Elder Blood... You blink and think on this thoughts. Maybe there will be a chance where you will invoke the famous Law of Surprise, just like some witchers did in the past! Your destiny is forth! ***

Would you like to RESTART, RESTORE a saved game, QUIT or UNDO the last command?

* * *

>ask about it
You can't see any such thing.

* * *

>ask the barber about it
The barber sets his razor down and leans forward. "You're here about the monster, aren't you? I can always tell. The eyes. And the swords, obviously." He lowers his voice to a theatrical whisper. "I'll tell you something no one else will. The creature... it was a child once. The king's daughter. Born of a cursed union, they say. The queen died in childbirth, and on that same night, the wise woman who came to deliver the girl laid a curse on her. Said she would not rest easy in death."

He picks up his razor again, examining the edge.

"Seven years she lay quiet in the crypt below the palace. Then she woke. Not herself. Not human." He draws a finger across his throat. "They sealed the palace after that. But she gets out sometimes. Into the district. People die."

>ask the merchant about it
The merchant looks you over with frank appraisal. "Silk," he says, offering his name like a coin. "I trade in fine goods. Or I did, before the palace business made this city a destination for the morbid and the desperate." He swirls his cup.

"You want to know about the monster. Everyone does." He leans back. "I was here when it first stirred. Seven years after the birth, as they say. I lost two good warehouse men that year. The thing comes out at night, crosses the district... But here is what I know that the others don't. It always returns before dawn. Always. Back to the crypt. Back to where it came from. I've watched."

He finishes his drink.

"I do not know why, but it returns every time, before the cock crows."

>see wallk
You can't see any such thing.

>see wall
Someone kept a record. The marks for the first seven years are faint. The marks after are deep, frantic, the scratching of a person who needed to remember. The curled figure and the eastern arrow are the last entry. No more marks after that.

You trace the marks with a finger. Seven years of nothing. Then the creature woke. The shape beside the seventh year mark, curled, like something sleeping. It rested in the crypt for seven years before it stirred. And the arrow east. Toward the palace. Toward the vaults below it.

You already know where you must go.

>go north
Castle Keep
The castle is old and smells of damp stone and old candles. Guards eye you at the gate but let you pass. They know the look of someone who has come about the contract. Inside, the keep is dim, the tapestries faded. Velerad's office is at the end of the main corridor.

Velerad is a heavyset man in his fifties with a soldier's posture and a bureaucrat's tired eyes. He sits behind a broad desk covered in papers.

A rolled map of the palace district lies on the corner of Velerad's desk.

A stiff parchment with Velerad's seal and the terms of the commission.

* * *

>go south
Herbalist's Shop
A low building that smells of dried things like herbs, roots, something sharper beneath. Bundles of plants hang from every rafter.

The herbalist is a small woman of indeterminate age. Her hands are stained with various dyes and preparations, and she does not look up from her work when you enter. You should ask her about the monster.

There is a black potion here. Small dark vial stoppered with wax. It smells faintly of something rotten.

There is another potion in small amber vial. It smells sharp and clean.

>ask her about it
I'm not sure what 'her' refers to.

>ask herbalist about it
She looks up at last.

"Velerad's witcher.". She says it flatly. "I know what you need. A Black Blood potion. Toxic to things that feed on human blood. They bite the drinker, they suffer for it.". She sets a small dark vial on the counter. "And Cat. For the dark. The palace vaults have no lanterns.". She adds a second vial, this one amber. You know the last one off course... The Black Blood is important, if the striga bites you, the poison passes to it. Slows it. It will not kill the creature, but it will weaken it." She names a price. It is not unreasonable. "Take both," she says. "Come back alive so I know if they worked."

>take it
You pocket the Cat potion. You will drink it before you go in.

* * *

>take black potion
You pocket the Black Blood potion carefully.

>go north
Market Square
The market is winding down for the evening. Stall holders roll up their cloth and argue over the day's takings. At the far end, a barber is still open, with his red and white pole catching the last of the light. On the opposite side, a merchant with silver streaked hair sits at a tavern table with a cup that never seems to empty.

The Barber is a thin and a fidgety man with nimble fingers and has restless eyes. He has the barber's habit of talking to fill silence, or to play the role of an unsolicited therapist. 

The merchant is a broad, well dressed man who seems entirely too comfortable for someone living in a city with a monster problem. He has the look of a man who has learned that gold can buy distance from most troubles. 

On the wall at the northern end of the market, near the palace gate, someone has scratched a crude calendar into the stone. Fourteen years worth of marks, each month noted. And beside the seventh year, a different mark, a rough shape like a curled, sleeping figure, and beside it an arrow pointing east. Toward the palace.

* * *

>go down
Palace Vaults
The stairs end in grey half-light. The cat potion does its work. The vault is a long, low corridor with a stoned floor. Several chambers open off it. The eastern chamber lies at the far end. The air is cold and carries something that is not rot and not animal but is both and neither.

It is quiet. At the far end, in the eastern chamber, the sarcophagus waits.

>go east
Eastern Chamber
A stone chamber. In the centre stands the sarcophagus, a heavy grey stone, its lid displaced, scored with deep claw marks along every edge. The smell is strong here. Old. Wrong.She is in here. You can hear her. A low sound, not quite animal, closer to something in pain. Movement near the large stone object at the room's centre. She is not attacking. Not yet.

 There is a heavy stone sarcophagus with its lid partially displaced. The stone around the edges is scored with claw marks, deep and repetitive, the work of years.

The sarcophagus. She is inside it. You can hear her breathing, slow and deep, through the gap in the lid.

>check it
 

You lean over the edge. She is there. In the first second you see a girl. Pale, thin, curled on her side. Then your eyes adjust and your hand goes to your sword before you have decided to move it.

The lid explodes upward. She comes out of the stone like something released from a trap. She is fast, very fast. In the grey dark she is all motion and sound, like a shriek that hits the low ceiling and breaks into something worse. Claws rake the wall where your head was. She lands on all fours, turns, and looks at you. You have to fight. Remember what you have! Silver sword, signs and potions!

>attack it
With you silver sword drawn, you push yourself further, with agile movements. You swing the silver sword in a wide arc. The blade catches her across the shoulder and she screams, a sound that is half animal, half something older and worse. Silver burns her and you can see it in the way she flinches back. Although she is screaming you notice that she is not weak... You need to weaken her somehow, and pass the night with her somehow.
Somehow you must survive until dawn with that beast. But how? Is there somewhere to hide? Somewhere you might use a sign to your advantage?

>attack it
With your silver sword drawn, you push forward with agile movements. You swing the blade in a wide arc. It catches her across the shoulder and she screams with a sound that is half animal, half something older and worse. Silver burns her and you can see it in the way she flinches back. But she is not weakened... You need to find another way. Check your inventory. Do you have something that could weaken her? Perhaps related to your blood?

Somehow you must survive until dawn with her. But how? Is there somewhere to hide? Somewhere you might use a sign to your advantage?

>save
Save failed.

>attack it
With your silver sword drawn, you push forward with agile movements. You swing the blade in a wide arc. It catches her across the shoulder and she screams with a sound that is half animal, half something older and worse. Silver burns her and you can see it in the way she flinches back. But she is not weakened... You need to find another way. Check your inventory. Do you have something that could weaken her? Perhaps related to your blood? Did you speak to the beautiful herbalist in town? Wait, do you even know her?

Somehow you must survive until dawn with her. But how? Is there somewhere to hide? Somewhere you might use a sign to your advantage?

>attack it
You raise your silver sword. One clean strike and it would be over. You do it. The vault falls silent.

You stand there for a moment, listening to the stillness. Then you hear boots on the stairs. Two guards, then four, then Velerad himself, lantern in hand. He takes in the scene. The broken sarcophagus, the sword in your hand still dripping, the silence... His face closes like a door. "You were told," he says. They take your swords first. Then your coin. The trial is brief and the king wants no spectacle. The sentence is read in a hall you will never leave.

Three thousand orens. That was all it would have taken. You should have explored more and found another way.

    *** You killed the king's daughter. Wyzim is the last city you will ever see. ***

Would you like to RESTART, RESTORE a saved game, QUIT or UNDO the last command?

* * *

>take both
Black Blood Potion: You pocket the Black Blood potion carefully.
Cat Potion: You pocket the Cat potion. You will drink it before you go in.

>go north
Market Square
The market is winding down for the evening. Stall holders roll up their cloth and argue over the day's takings. At the far end, a barber is still open, with his red and white pole catching the last of the light. On the opposite side, a merchant with silver streaked hair sits at a tavern table with a cup that never seems to empty.

The Barber is a thin and a fidgety man with nimble fingers and has restless eyes. He has the barber's habit of talking to fill silence, or to play the role of an unsolicited therapist. You can try and ask him about the proclamation.

The merchant is a broad, well dressed man who seems entirely too comfortable for someone living in a city with a monster problem. He has the look of a man who has learned that gold can buy distance from most troubles. You can try and ask him about the proclamation.

On the wall at the northern end of the market, near the palace gate, someone has scratched a crude calendar into the stone. Fourteen years worth of marks, each month noted. And beside the seventh year, a different mark, a rough shape like a curled, sleeping figure, and beside it an arrow pointing east. Toward the palace.

* * *

>drink cat potion
You uncork the Cat potion and drink it in one swallow. Bitter as ash. For a moment the world dims, and then snaps back sharper than before. The dark is grey instead of black, shapes clear and distinct. You can see. Your cat eyes... are different.

You see the heavy lid of the sarcophagus begin to slide. A pale, clawed hand hooks over the edge, and with a sudden, violent burst of strength, she flings herself out. She crouches on the stone floor, her eyes reflecting the faint light, fixed entirely on you. You will need to fight it. Remember what you have!
 The black potion can weaken it, but you need let her attack you. Plus you need to make her retreat. Use your silver sword or signs.

>drink black potion
You reach for the potion... but she moves before you can uncork it. You barely manage to dodge. This is not the moment. You should have drunk it before entering. Try pushing her back first with a sign, or your sword... and then drink it.

>attack it
With you silver sword drawn, you push yourself further, with agile movements. You swing the silver sword in a wide arc. The blade catches her across the shoulder and she screams, a sound that is half animal, half something older and worse. Silver burns her and you can see it in the way she flinches back. Although she is screaming you notice that she is not weak... You need to weaken her somehow, and pass the night with her somehow.
You still have the Black Blood Potion. You remember what the herbalist told you... Perhaps you should drink it and let her come to you.

>drink black potion
You uncork it and swallow it in one go. No taste. Nothing. A moment later she is on you. Her jaws close on your forearm. Then she recoils, shrieking, shaking her head as if trying to rid herself of something she cannot name. The Black Blood did its work, and fast. She stumbles back, snarling and confused.

She is slowing down. This is your chance to finish her... But you will not receive the orens and you will be wanted by the crown of Foltest. You need to hide until dawn. Where can you go?

>finish her
With you silver sword on your hand, you walk twoards her. You raise your silver sword. One clean strike. It would be over... You do it.

The vault goes quiet. You stand there for a moment, listening to the silence. Then you hear boots on the stairs. Two guards, then four, then Velerad himself, lantern in hand. He takes in the scene. The broken sarcophagus. The sword in your hand. The stillness. His face closes like a door.

"You were told," he says. Quietly. That is worse than shouting. They take your swords first. Then your coin. The trial is brief since the king does not want a spectacle. The sentence is read in a hall you will never leave.

Three thousand oren. That was all it would have taken.

    *** You killed the king's daughter. Wyzim is the last city you will ever see. ***

Would you like to RESTART, RESTORE a saved game, QUIT or UNDO the last command?

>attack her
Please give one of the answers above.

Would you like to RESTART, RESTORE a saved game, QUIT or UNDO the last command?

>go north
Please give one of the answers above.

Would you like to RESTART, RESTORE a saved game, QUIT or UNDO the last command?

* * *

>go west
Please give one of the answers above.

Would you like to RESTART, RESTORE a saved game, QUIT or UNDO the last command?

>wait
Please give one of the answers above.

Would you like to RESTART, RESTORE a saved game, QUIT or UNDO the last command?

>wait
Please give one of the answers above.

Would you like to RESTART, RESTORE a saved game, QUIT or UNDO the last command?

>go east
Please give one of the answers above.

Would you like to RESTART, RESTORE a saved game, QUIT or UNDO the last command?

* * *

>see wad
You get closer and see that it is a proclamation, signed by Foltest, King of Temeria, Pontar and Mahakam... You might want to examine it further to read the details.

>examine wad
You get closer and see that it is a proclamation, signed by Foltest, King of Temeria, Pontar and Mahakam... You might want to examine it further to read the details.

>examine further
You can't see any such thing.

>examine wad
You read the proclamation carefully:

"BY ORDER OF KING FOLTEST OF TEMERIA

Let it be known to all citizens of Wyzim and its surroundings:

The palace district is hereby forbidden to all persons, by penalty of death. None shall enter, none shall linger after dark.

A creature of unknown nature dwells within the old palace vaults. It is dangerous. It kills. Fourteen years have passed since the curse was laid and seven since it first stirred.

His Majesty King Foltest, in his mercy, forbids any attempt upon the creature's life.

His Majesty hereby calls upon any man of skill and knowledge, witcher, sorcerer, or wise man, who believes themselves capable of lifting the curse upon the creature, to present themselves before the castellan Velerad at Wyzim.

Any man or woman capable of lifting the curse without harm to the creature shall be rewarded handsomely by the crown with three thousand oren.

Those who attempt to destroy the creature instead of breaking the spell will be tried for treason."

You think about pulling it off in case you need to ask about it.

>nigga
That's not a verb I recognise.

* * *

>south
You push open the door of The Fox. The hinges creak. Inside, it is dim and quiet. Just the way you like it.

* * *

>take it
You peel of the leather, and read carefully the proclamation:

BY ORDER OF KING FOLTEST OF TEMERIA

 Let it be known to all citizens of Wyzim and its surroundings:

 The palace district is hereby forbidden to all persons, by penalty of death. None shall enter, none shall linger after dark.

 A creature of unknown nature dwells within the old palace vaults. It is dangerous. It kills. Fourteen years have passed since the curse was laid and seven since it first stirred.

 His Majesty King Foltest, in his mercy, forbids any attempt upon the creature's life.

 His Majesty hereby calls upon any man of skill and knowledge, witcher, sorcerer, or wise man, who believes themselves capable of lifting the curse upon the creature, to present themselves before the castellan Velerad at Wyzim.

 Any man or woman capable of lifting the curse without harm to the creature shall be rewarded handsomely by the crown with three thousand oren. Those who attempt to destroy the creature instead of breaking the spell will be tried for treason.

>inventory
You are carrying:
  a wad of white goat leather

* * *

>view it
You get closer and see that it is a proclamation, signed by Foltest, King of Temeria, Pontar and Mahakam... You might want to examine it further to read the details.

>stare at it
You read the proclamation carefully:

"BY ORDER OF KING FOLTEST OF TEMERIA

Let it be known to all citizens of Wyzim and its surroundings:

The palace district is hereby forbidden to all persons, by penalty of death. None shall enter, none shall linger after dark.

A creature of unknown nature dwells within the old palace vaults. It is dangerous. It kills. Fourteen years have passed since the curse was laid and seven since it first stirred.

His Majesty King Foltest, in his mercy, forbids any attempt upon the creature's life.

His Majesty hereby calls upon any man of skill and knowledge, witcher, sorcerer, or wise man, who believes themselves capable of lifting the curse upon the creature, to present themselves before the castellan Velerad at Wyzim.

Any man or woman capable of lifting the curse without harm to the creature shall be rewarded handsomely by the crown with three thousand oren.

Those who attempt to destroy the creature instead of breaking the spell will be tried for treason."

You think about pulling it off in case you need to ask about it.